가: KIYEOK-A, GA
각: KIYEOK-A-KIYEOK, GAG
간: KIYEOK-A-NIEUN, GAN
갇: KIYEOK-A-TIKEUT, GAD
갈: KIYEOK-A-RIEUL, GAL
갉: KIYEOK-A-RIEULKIYEOK, GALG
갊: KIYEOK-A-RIEULMIEUM, GALM
감: KIYEOK-A-MIEUM, GAM
갑: KIYEOK-A-PIEUP, GAB
값: KIYEOK-A-PIEUPSIOS, GABS
갓: KIYEOK-A-SIOS, GAS
갔: KIYEOK-A-SSANGSIOS, GASS
강: KIYEOK-A-IEUNG, GANG
갖: KIYEOK-A-CIEUC, GAJ
갗: KIYEOK-A-CHIEUCH, GAC
같: KIYEOK-A-THIEUTH, GAT
갚: KIYEOK-A-PHIEUPH, GAP
갛: KIYEOK-A-HIEUH, GAH
개: KIYEOK-AE, GAE
객: KIYEOK-AE-KIYEOK, GAEG
갠: KIYEOK-AE-NIEUN, GAEN
갤: KIYEOK-AE-RIEUL, GAEL
갬: KIYEOK-AE-MIEUM, GAEM
갭: KIYEOK-AE-PIEUP, GAEB
갯: KIYEOK-AE-SIOS, GAES
갰: KIYEOK-AE-SSANGSIOS, GAESS
갱: KIYEOK-AE-IEUNG, GAENG
갸: KIYEOK-YA, GYA
갹: KIYEOK-YA-KIYEOK, GYAG
갼: KIYEOK-YA-NIEUN, GYAN
걀: KIYEOK-YA-RIEUL, GYAL
걋: KIYEOK-YA-SIOS, GYAS
걍: KIYEOK-YA-IEUNG, GYANG
걔: KIYEOK-YAE, GYAE
걘: KIYEOK-YAE-NIEUN, GYAEN
걜: KIYEOK-YAE-RIEUL, GYAEL
거: KIYEOK-EO, GEO
걱: KIYEOK-EO-KIYEOK, GEOG
건: KIYEOK-EO-NIEUN, GEON
걷: KIYEOK-EO-TIKEUT, GEOD
걸: KIYEOK-EO-RIEUL, GEOL
걺: KIYEOK-EO-RIEULMIEUM, GEOLM
검: KIYEOK-EO-MIEUM, GEOM
겁: KIYEOK-EO-PIEUP, GEOB
것: KIYEOK-EO-SIOS, GEOS
겄: KIYEOK-EO-SSANGSIOS, GEOSS
겅: KIYEOK-EO-IEUNG, GEONG
겆: KIYEOK-EO-CIEUC, GEOJ
겉: KIYEOK-EO-THIEUTH, GEOT
겊: KIYEOK-EO-PHIEUPH, GEOP
겋: KIYEOK-EO-HIEUH, GEOH
게: KIYEOK-E, GE
겐: KIYEOK-E-NIEUN, GEN
겔: KIYEOK-E-RIEUL, GEL
겜: KIYEOK-E-MIEUM, GEM
겝: KIYEOK-E-PIEUP, GEB
겟: KIYEOK-E-SIOS, GES
겠: KIYEOK-E-SSANGSIOS, GESS
겡: KIYEOK-E-IEUNG, GENG
겨: KIYEOK-YEO, GYEO
격: KIYEOK-YEO-KIYEOK, GYEOG
겪: KIYEOK-YEO-SSANGKIYEOK, GYEOGG
견: KIYEOK-YEO-NIEUN, GYEON
겯: KIYEOK-YEO-TIKEUT, GYEOD
결: KIYEOK-YEO-RIEUL, GYEOL
겸: KIYEOK-YEO-MIEUM, GYEOM
겹: KIYEOK-YEO-PIEUP, GYEOB
겻: KIYEOK-YEO-SIOS, GYEOS
겼: KIYEOK-YEO-SSANGSIOS, GYEOSS
경: KIYEOK-YEO-IEUNG, GYEONG
곁: KIYEOK-YEO-THIEUTH, GYEOT
계: KIYEOK-YE, GYE
곈: KIYEOK-YE-NIEUN, GYEN
곌: KIYEOK-YE-RIEUL, GYEL
곕: KIYEOK-YE-PIEUP, GYEB
곗: KIYEOK-YE-SIOS, GYES
고: KIYEOK-O, GO
곡: KIYEOK-O-KIYEOK, GOG
곤: KIYEOK-O-NIEUN, GON
곧: KIYEOK-O-TIKEUT, GOD
골: KIYEOK-O-RIEUL, GOL
곪: KIYEOK-O-RIEULMIEUM, GOLM
곬: KIYEOK-O-RIEULSIOS, GOLS
곯: KIYEOK-O-RIEULHIEUH, GOLH
곰: KIYEOK-O-MIEUM, GOM
곱: KIYEOK-O-PIEUP, GOB
곳: KIYEOK-O-SIOS, GOS
공: KIYEOK-O-IEUNG, GONG
곶: KIYEOK-O-CIEUC, GOJ
과: KIYEOK-WA, GWA
곽: KIYEOK-WA-KIYEOK, GWAG
관: KIYEOK-WA-NIEUN, GWAN
괄: KIYEOK-WA-RIEUL, GWAL
괆: KIYEOK-WA-RIEULMIEUM, GWALM
괌: KIYEOK-WA-MIEUM, GWAM
괍: KIYEOK-WA-PIEUP, GWAB
괏: KIYEOK-WA-SIOS, GWAS
광: KIYEOK-WA-IEUNG, GWANG
괘: KIYEOK-WAE, GWAE
괜: KIYEOK-WAE-NIEUN, GWAEN
괠: KIYEOK-WAE-RIEUL, GWAEL
괩: KIYEOK-WAE-PIEUP, GWAEB
괬: KIYEOK-WAE-SSANGSIOS, GWAESS
괭: KIYEOK-WAE-IEUNG, GWAENG
괴: KIYEOK-OE, GOE
괵: KIYEOK-OE-KIYEOK, GOEG
괸: KIYEOK-OE-NIEUN, GOEN
괼: KIYEOK-OE-RIEUL, GOEL
굄: KIYEOK-OE-MIEUM, GOEM
굅: KIYEOK-OE-PIEUP, GOEB
굇: KIYEOK-OE-SIOS, GOES
굉: KIYEOK-OE-IEUNG, GOENG
교: KIYEOK-YO, GYO
굔: KIYEOK-YO-NIEUN, GYON
굘: KIYEOK-YO-RIEUL, GYOL
굡: KIYEOK-YO-PIEUP, GYOB
굣: KIYEOK-YO-SIOS, GYOS
구: KIYEOK-U, GU
국: KIYEOK-U-KIYEOK, GUG
군: KIYEOK-U-NIEUN, GUN
굳: KIYEOK-U-TIKEUT, GUD
굴: KIYEOK-U-RIEUL, GUL
굵: KIYEOK-U-RIEULKIYEOK, GULG
굶: KIYEOK-U-RIEULMIEUM, GULM
굻: KIYEOK-U-RIEULHIEUH, GULH
굼: KIYEOK-U-MIEUM, GUM
굽: KIYEOK-U-PIEUP, GUB
굿: KIYEOK-U-SIOS, GUS
궁: KIYEOK-U-IEUNG, GUNG
궂: KIYEOK-U-CIEUC, GUJ
궈: KIYEOK-WEO, GWEO
궉: KIYEOK-WEO-KIYEOK, GWEOG
권: KIYEOK-WEO-NIEUN, GWEON
궐: KIYEOK-WEO-RIEUL, GWEOL
궜: KIYEOK-WEO-SSANGSIOS, GWEOSS
궝: KIYEOK-WEO-IEUNG, GWEONG
궤: KIYEOK-WE, GWE
궷: KIYEOK-WE-SIOS, GWES
귀: KIYEOK-WI, GWI
귁: KIYEOK-WI-KIYEOK, GWIG
귄: KIYEOK-WI-NIEUN, GWIN
귈: KIYEOK-WI-RIEUL, GWIL
귐: KIYEOK-WI-MIEUM, GWIM
귑: KIYEOK-WI-PIEUP, GWIB
귓: KIYEOK-WI-SIOS, GWIS
규: KIYEOK-YU, GYU
균: KIYEOK-YU-NIEUN, GYUN
귤: KIYEOK-YU-RIEUL, GYUL
그: KIYEOK-EU, GEU
극: KIYEOK-EU-KIYEOK, GEUG
근: KIYEOK-EU-NIEUN, GEUN
귿: KIYEOK-EU-TIKEUT, GEUD
글: KIYEOK-EU-RIEUL, GEUL
긁: KIYEOK-EU-RIEULKIYEOK, GEULG
금: KIYEOK-EU-MIEUM, GEUM
급: KIYEOK-EU-PIEUP, GEUB
긋: KIYEOK-EU-SIOS, GEUS
긍: KIYEOK-EU-IEUNG, GEUNG
긔: KIYEOK-YI, GYI
기: KIYEOK-I, GI
긱: KIYEOK-I-KIYEOK, GIG
긴: KIYEOK-I-NIEUN, GIN
긷: KIYEOK-I-TIKEUT, GID
길: KIYEOK-I-RIEUL, GIL
긺: KIYEOK-I-RIEULMIEUM, GILM
김: KIYEOK-I-MIEUM, GIM
깁: KIYEOK-I-PIEUP, GIB
깃: KIYEOK-I-SIOS, GIS
깅: KIYEOK-I-IEUNG, GING
깆: KIYEOK-I-CIEUC, GIJ
깊: KIYEOK-I-PHIEUPH, GIP
까: SSANGKIYEOK-A, GGA
깍: SSANGKIYEOK-A-KIYEOK, GGAG
깎: SSANGKIYEOK-A-SSANGKIYEOK, GGAGG
깐: SSANGKIYEOK-A-NIEUN, GGAN
깔: SSANGKIYEOK-A-RIEUL, GGAL
깖: SSANGKIYEOK-A-RIEULMIEUM, GGALM
깜: SSANGKIYEOK-A-MIEUM, GGAM
깝: SSANGKIYEOK-A-PIEUP, GGAB
깟: SSANGKIYEOK-A-SIOS, GGAS
깠: SSANGKIYEOK-A-SSANGSIOS, GGASS
깡: SSANGKIYEOK-A-IEUNG, GGANG
깥: SSANGKIYEOK-A-THIEUTH, GGAT
깨: SSANGKIYEOK-AE, GGAE
깩: SSANGKIYEOK-AE-KIYEOK, GGAEG
깬: SSANGKIYEOK-AE-NIEUN, GGAEN
깰: SSANGKIYEOK-AE-RIEUL, GGAEL
깸: SSANGKIYEOK-AE-MIEUM, GGAEM
깹: SSANGKIYEOK-AE-PIEUP, GGAEB
깻: SSANGKIYEOK-AE-SIOS, GGAES
깼: SSANGKIYEOK-AE-SSANGSIOS, GGAESS
깽: SSANGKIYEOK-AE-IEUNG, GGAENG
꺄: SSANGKIYEOK-YA, GGYA
꺅: SSANGKIYEOK-YA-KIYEOK, GGYAG
꺌: SSANGKIYEOK-YA-RIEUL, GGYAL
꺼: SSANGKIYEOK-EO, GGEO
꺽: SSANGKIYEOK-EO-KIYEOK, GGEOG
꺾: SSANGKIYEOK-EO-SSANGKIYEOK, GGEOGG
껀: SSANGKIYEOK-EO-NIEUN, GGEON
껄: SSANGKIYEOK-EO-RIEUL, GGEOL
껌: SSANGKIYEOK-EO-MIEUM, GGEOM
껍: SSANGKIYEOK-EO-PIEUP, GGEOB
껏: SSANGKIYEOK-EO-SIOS, GGEOS
껐: SSANGKIYEOK-EO-SSANGSIOS, GGEOSS
껑: SSANGKIYEOK-EO-IEUNG, GGEONG
께: SSANGKIYEOK-E, GGE
껙: SSANGKIYEOK-E-KIYEOK, GGEG
껜: SSANGKIYEOK-E-NIEUN, GGEN
껨: SSANGKIYEOK-E-MIEUM, GGEM
껫: SSANGKIYEOK-E-SIOS, GGES
껭: SSANGKIYEOK-E-IEUNG, GGENG
껴: SSANGKIYEOK-YEO, GGYEO
껸: SSANGKIYEOK-YEO-NIEUN, GGYEON
껼: SSANGKIYEOK-YEO-RIEUL, GGYEOL
꼇: SSANGKIYEOK-YEO-SIOS, GGYEOS
꼈: SSANGKIYEOK-YEO-SSANGSIOS, GGYEOSS
꼍: SSANGKIYEOK-YEO-THIEUTH, GGYEOT
꼐: SSANGKIYEOK-YE, GGYE
꼬: SSANGKIYEOK-O, GGO
꼭: SSANGKIYEOK-O-KIYEOK, GGOG
꼰: SSANGKIYEOK-O-NIEUN, GGON
꼲: SSANGKIYEOK-O-NIEUNHIEUH, GGONH
꼴: SSANGKIYEOK-O-RIEUL, GGOL
꼼: SSANGKIYEOK-O-MIEUM, GGOM
꼽: SSANGKIYEOK-O-PIEUP, GGOB
꼿: SSANGKIYEOK-O-SIOS, GGOS
꽁: SSANGKIYEOK-O-IEUNG, GGONG
꽂: SSANGKIYEOK-O-CIEUC, GGOJ
꽃: SSANGKIYEOK-O-CHIEUCH, GGOC
꽈: SSANGKIYEOK-WA, GGWA
꽉: SSANGKIYEOK-WA-KIYEOK, GGWAG
꽐: SSANGKIYEOK-WA-RIEUL, GGWAL
꽜: SSANGKIYEOK-WA-SSANGSIOS, GGWASS
꽝: SSANGKIYEOK-WA-IEUNG, GGWANG
꽤: SSANGKIYEOK-WAE, GGWAE
꽥: SSANGKIYEOK-WAE-KIYEOK, GGWAEG
꽹: SSANGKIYEOK-WAE-IEUNG, GGWAENG
꾀: SSANGKIYEOK-OE, GGOE
꾄: SSANGKIYEOK-OE-NIEUN, GGOEN
꾈: SSANGKIYEOK-OE-RIEUL, GGOEL
꾐: SSANGKIYEOK-OE-MIEUM, GGOEM
꾑: SSANGKIYEOK-OE-PIEUP, GGOEB
꾕: SSANGKIYEOK-OE-IEUNG, GGOENG
꾜: SSANGKIYEOK-YO, GGYO
꾸: SSANGKIYEOK-U, GGU
꾹: SSANGKIYEOK-U-KIYEOK, GGUG
꾼: SSANGKIYEOK-U-NIEUN, GGUN
꿀: SSANGKIYEOK-U-RIEUL, GGUL
꿇: SSANGKIYEOK-U-RIEULHIEUH, GGULH
꿈: SSANGKIYEOK-U-MIEUM, GGUM
꿉: SSANGKIYEOK-U-PIEUP, GGUB
꿋: SSANGKIYEOK-U-SIOS, GGUS
꿍: SSANGKIYEOK-U-IEUNG, GGUNG
꿎: SSANGKIYEOK-U-CIEUC, GGUJ
꿔: SSANGKIYEOK-WEO, GGWEO
꿜: SSANGKIYEOK-WEO-RIEUL, GGWEOL
꿨: SSANGKIYEOK-WEO-SSANGSIOS, GGWEOSS
꿩: SSANGKIYEOK-WEO-IEUNG, GGWEONG
꿰: SSANGKIYEOK-WE, GGWE
꿱: SSANGKIYEOK-WE-KIYEOK, GGWEG
꿴: SSANGKIYEOK-WE-NIEUN, GGWEN
꿸: SSANGKIYEOK-WE-RIEUL, GGWEL
뀀: SSANGKIYEOK-WE-MIEUM, GGWEM
뀁: SSANGKIYEOK-WE-PIEUP, GGWEB
뀄: SSANGKIYEOK-WE-SSANGSIOS, GGWESS
뀌: SSANGKIYEOK-WI, GGWI
뀐: SSANGKIYEOK-WI-NIEUN, GGWIN
뀔: SSANGKIYEOK-WI-RIEUL, GGWIL
뀜: SSANGKIYEOK-WI-MIEUM, GGWIM
뀝: SSANGKIYEOK-WI-PIEUP, GGWIB
뀨: SSANGKIYEOK-YU, GGYU
끄: SSANGKIYEOK-EU, GGEU
끅: SSANGKIYEOK-EU-KIYEOK, GGEUG
끈: SSANGKIYEOK-EU-NIEUN, GGEUN
끊: SSANGKIYEOK-EU-NIEUNHIEUH, GGEUNH
끌: SSANGKIYEOK-EU-RIEUL, GGEUL
끎: SSANGKIYEOK-EU-RIEULMIEUM, GGEULM
끓: SSANGKIYEOK-EU-RIEULHIEUH, GGEULH
끔: SSANGKIYEOK-EU-MIEUM, GGEUM
끕: SSANGKIYEOK-EU-PIEUP, GGEUB
끗: SSANGKIYEOK-EU-SIOS, GGEUS
끙: SSANGKIYEOK-EU-IEUNG, GGEUNG
끝: SSANGKIYEOK-EU-THIEUTH, GGEUT
끼: SSANGKIYEOK-I, GGI
끽: SSANGKIYEOK-I-KIYEOK, GGIG
낀: SSANGKIYEOK-I-NIEUN, GGIN
낄: SSANGKIYEOK-I-RIEUL, GGIL
낌: SSANGKIYEOK-I-MIEUM, GGIM
낍: SSANGKIYEOK-I-PIEUP, GGIB
낏: SSANGKIYEOK-I-SIOS, GGIS
낑: SSANGKIYEOK-I-IEUNG, GGING
나: NIEUN-A, NA
낙: NIEUN-A-KIYEOK, NAG
낚: NIEUN-A-SSANGKIYEOK, NAGG
난: NIEUN-A-NIEUN, NAN
낟: NIEUN-A-TIKEUT, NAD
날: NIEUN-A-RIEUL, NAL
낡: NIEUN-A-RIEULKIYEOK, NALG
낢: NIEUN-A-RIEULMIEUM, NALM
남: NIEUN-A-MIEUM, NAM
납: NIEUN-A-PIEUP, NAB
낫: NIEUN-A-SIOS, NAS
났: NIEUN-A-SSANGSIOS, NASS
낭: NIEUN-A-IEUNG, NANG
낮: NIEUN-A-CIEUC, NAJ
낯: NIEUN-A-CHIEUCH, NAC
낱: NIEUN-A-THIEUTH, NAT
낳: NIEUN-A-HIEUH, NAH
내: NIEUN-AE, NAE
낵: NIEUN-AE-KIYEOK, NAEG
낸: NIEUN-AE-NIEUN, NAEN
낼: NIEUN-AE-RIEUL, NAEL
냄: NIEUN-AE-MIEUM, NAEM
냅: NIEUN-AE-PIEUP, NAEB
냇: NIEUN-AE-SIOS, NAES
냈: NIEUN-AE-SSANGSIOS, NAESS
냉: NIEUN-AE-IEUNG, NAENG
냐: NIEUN-YA, NYA
냑: NIEUN-YA-KIYEOK, NYAG
냔: NIEUN-YA-NIEUN, NYAN
냘: NIEUN-YA-RIEUL, NYAL
냠: NIEUN-YA-MIEUM, NYAM
냥: NIEUN-YA-IEUNG, NYANG
너: NIEUN-EO, NEO
넉: NIEUN-EO-KIYEOK, NEOG
넋: NIEUN-EO-KIYEOKSIOS, NEOGS
넌: NIEUN-EO-NIEUN, NEON
널: NIEUN-EO-RIEUL, NEOL
넒: NIEUN-EO-RIEULMIEUM, NEOLM
넓: NIEUN-EO-RIEULPIEUP, NEOLB
넘: NIEUN-EO-MIEUM, NEOM
넙: NIEUN-EO-PIEUP, NEOB
넛: NIEUN-EO-SIOS, NEOS
넜: NIEUN-EO-SSANGSIOS, NEOSS
넝: NIEUN-EO-IEUNG, NEONG
넣: NIEUN-EO-HIEUH, NEOH
네: NIEUN-E, NE
넥: NIEUN-E-KIYEOK, NEG
넨: NIEUN-E-NIEUN, NEN
넬: NIEUN-E-RIEUL, NEL
넴: NIEUN-E-MIEUM, NEM
넵: NIEUN-E-PIEUP, NEB
넷: NIEUN-E-SIOS, NES
넸: NIEUN-E-SSANGSIOS, NESS
넹: NIEUN-E-IEUNG, NENG
녀: NIEUN-YEO, NYEO
녁: NIEUN-YEO-KIYEOK, NYEOG
년: NIEUN-YEO-NIEUN, NYEON
녈: NIEUN-YEO-RIEUL, NYEOL
념: NIEUN-YEO-MIEUM, NYEOM
녑: NIEUN-YEO-PIEUP, NYEOB
녔: NIEUN-YEO-SSANGSIOS, NYEOSS
녕: NIEUN-YEO-IEUNG, NYEONG
녘: NIEUN-YEO-KHIEUKH, NYEOK
녜: NIEUN-YE, NYE
녠: NIEUN-YE-NIEUN, NYEN
노: NIEUN-O, NO
녹: NIEUN-O-KIYEOK, NOG
논: NIEUN-O-NIEUN, NON
놀: NIEUN-O-RIEUL, NOL
놂: NIEUN-O-RIEULMIEUM, NOLM
놈: NIEUN-O-MIEUM, NOM
놉: NIEUN-O-PIEUP, NOB
놋: NIEUN-O-SIOS, NOS
농: NIEUN-O-IEUNG, NONG
높: NIEUN-O-PHIEUPH, NOP
놓: NIEUN-O-HIEUH, NOH
놔: NIEUN-WA, NWA
놘: NIEUN-WA-NIEUN, NWAN
놜: NIEUN-WA-RIEUL, NWAL
놨: NIEUN-WA-SSANGSIOS, NWASS
뇌: NIEUN-OE, NOE
뇐: NIEUN-OE-NIEUN, NOEN
뇔: NIEUN-OE-RIEUL, NOEL
뇜: NIEUN-OE-MIEUM, NOEM
뇝: NIEUN-OE-PIEUP, NOEB
뇟: NIEUN-OE-SIOS, NOES
뇨: NIEUN-YO, NYO
뇩: NIEUN-YO-KIYEOK, NYOG
뇬: NIEUN-YO-NIEUN, NYON
뇰: NIEUN-YO-RIEUL, NYOL
뇹: NIEUN-YO-PIEUP, NYOB
뇻: NIEUN-YO-SIOS, NYOS
뇽: NIEUN-YO-IEUNG, NYONG
누: NIEUN-U, NU
눅: NIEUN-U-KIYEOK, NUG
눈: NIEUN-U-NIEUN, NUN
눋: NIEUN-U-TIKEUT, NUD
눌: NIEUN-U-RIEUL, NUL
눔: NIEUN-U-MIEUM, NUM
눕: NIEUN-U-PIEUP, NUB
눗: NIEUN-U-SIOS, NUS
눙: NIEUN-U-IEUNG, NUNG
눠: NIEUN-WEO, NWEO
눴: NIEUN-WEO-SSANGSIOS, NWEOSS
눼: NIEUN-WE, NWE
뉘: NIEUN-WI, NWI
뉜: NIEUN-WI-NIEUN, NWIN
뉠: NIEUN-WI-RIEUL, NWIL
뉨: NIEUN-WI-MIEUM, NWIM
뉩: NIEUN-WI-PIEUP, NWIB
뉴: NIEUN-YU, NYU
뉵: NIEUN-YU-KIYEOK, NYUG
뉼: NIEUN-YU-RIEUL, NYUL
늄: NIEUN-YU-MIEUM, NYUM
늅: NIEUN-YU-PIEUP, NYUB
늉: NIEUN-YU-IEUNG, NYUNG
느: NIEUN-EU, NEU
늑: NIEUN-EU-KIYEOK, NEUG
는: NIEUN-EU-NIEUN, NEUN
늘: NIEUN-EU-RIEUL, NEUL
늙: NIEUN-EU-RIEULKIYEOK, NEULG
늚: NIEUN-EU-RIEULMIEUM, NEULM
늠: NIEUN-EU-MIEUM, NEUM
늡: NIEUN-EU-PIEUP, NEUB
늣: NIEUN-EU-SIOS, NEUS
능: NIEUN-EU-IEUNG, NEUNG
늦: NIEUN-EU-CIEUC, NEUJ
늪: NIEUN-EU-PHIEUPH, NEUP
늬: NIEUN-YI, NYI
늰: NIEUN-YI-NIEUN, NYIN
늴: NIEUN-YI-RIEUL, NYIL
니: NIEUN-I, NI
닉: NIEUN-I-KIYEOK, NIG
닌: NIEUN-I-NIEUN, NIN
닐: NIEUN-I-RIEUL, NIL
닒: NIEUN-I-RIEULMIEUM, NILM
님: NIEUN-I-MIEUM, NIM
닙: NIEUN-I-PIEUP, NIB
닛: NIEUN-I-SIOS, NIS
닝: NIEUN-I-IEUNG, NING
닢: NIEUN-I-PHIEUPH, NIP
다: TIKEUT-A, DA
닥: TIKEUT-A-KIYEOK, DAG
닦: TIKEUT-A-SSANGKIYEOK, DAGG
단: TIKEUT-A-NIEUN, DAN
닫: TIKEUT-A-TIKEUT, DAD
달: TIKEUT-A-RIEUL, DAL
닭: TIKEUT-A-RIEULKIYEOK, DALG
닮: TIKEUT-A-RIEULMIEUM, DALM
닯: TIKEUT-A-RIEULPIEUP, DALB
닳: TIKEUT-A-RIEULHIEUH, DALH
담: TIKEUT-A-MIEUM, DAM
답: TIKEUT-A-PIEUP, DAB
닷: TIKEUT-A-SIOS, DAS
닸: TIKEUT-A-SSANGSIOS, DASS
당: TIKEUT-A-IEUNG, DANG
닺: TIKEUT-A-CIEUC, DAJ
닻: TIKEUT-A-CHIEUCH, DAC
닿: TIKEUT-A-HIEUH, DAH
대: TIKEUT-AE, DAE
댁: TIKEUT-AE-KIYEOK, DAEG
댄: TIKEUT-AE-NIEUN, DAEN
댈: TIKEUT-AE-RIEUL, DAEL
댐: TIKEUT-AE-MIEUM, DAEM
댑: TIKEUT-AE-PIEUP, DAEB
댓: TIKEUT-AE-SIOS, DAES
댔: TIKEUT-AE-SSANGSIOS, DAESS
댕: TIKEUT-AE-IEUNG, DAENG
댜: TIKEUT-YA, DYA
더: TIKEUT-EO, DEO
덕: TIKEUT-EO-KIYEOK, DEOG
덖: TIKEUT-EO-SSANGKIYEOK, DEOGG
던: TIKEUT-EO-NIEUN, DEON
덛: TIKEUT-EO-TIKEUT, DEOD
덜: TIKEUT-EO-RIEUL, DEOL
덞: TIKEUT-EO-RIEULMIEUM, DEOLM
덟: TIKEUT-EO-RIEULPIEUP, DEOLB
덤: TIKEUT-EO-MIEUM, DEOM
덥: TIKEUT-EO-PIEUP, DEOB
덧: TIKEUT-EO-SIOS, DEOS
덩: TIKEUT-EO-IEUNG, DEONG
덫: TIKEUT-EO-CHIEUCH, DEOC
덮: TIKEUT-EO-PHIEUPH, DEOP
데: TIKEUT-E, DE
덱: TIKEUT-E-KIYEOK, DEG
덴: TIKEUT-E-NIEUN, DEN
델: TIKEUT-E-RIEUL, DEL
뎀: TIKEUT-E-MIEUM, DEM
뎁: TIKEUT-E-PIEUP, DEB
뎃: TIKEUT-E-SIOS, DES
뎄: TIKEUT-E-SSANGSIOS, DESS
뎅: TIKEUT-E-IEUNG, DENG
뎌: TIKEUT-YEO, DYEO
뎐: TIKEUT-YEO-NIEUN, DYEON
뎔: TIKEUT-YEO-RIEUL, DYEOL
뎠: TIKEUT-YEO-SSANGSIOS, DYEOSS
뎡: TIKEUT-YEO-IEUNG, DYEONG
뎨: TIKEUT-YE, DYE
뎬: TIKEUT-YE-NIEUN, DYEN
도: TIKEUT-O, DO
독: TIKEUT-O-KIYEOK, DOG
돈: TIKEUT-O-NIEUN, DON
돋: TIKEUT-O-TIKEUT, DOD
돌: TIKEUT-O-RIEUL, DOL
돎: TIKEUT-O-RIEULMIEUM, DOLM
돐: TIKEUT-O-RIEULSIOS, DOLS
돔: TIKEUT-O-MIEUM, DOM
돕: TIKEUT-O-PIEUP, DOB
돗: TIKEUT-O-SIOS, DOS
동: TIKEUT-O-IEUNG, DONG
돛: TIKEUT-O-CHIEUCH, DOC
돝: TIKEUT-O-THIEUTH, DOT
돠: TIKEUT-WA, DWA
돤: TIKEUT-WA-NIEUN, DWAN
돨: TIKEUT-WA-RIEUL, DWAL
돼: TIKEUT-WAE, DWAE
됐: TIKEUT-WAE-SSANGSIOS, DWAESS
되: TIKEUT-OE, DOE
된: TIKEUT-OE-NIEUN, DOEN
될: TIKEUT-OE-RIEUL, DOEL
됨: TIKEUT-OE-MIEUM, DOEM
됩: TIKEUT-OE-PIEUP, DOEB
됫: TIKEUT-OE-SIOS, DOES
됴: TIKEUT-YO, DYO
두: TIKEUT-U, DU
둑: TIKEUT-U-KIYEOK, DUG
둔: TIKEUT-U-NIEUN, DUN
둘: TIKEUT-U-RIEUL, DUL
둠: TIKEUT-U-MIEUM, DUM
둡: TIKEUT-U-PIEUP, DUB
둣: TIKEUT-U-SIOS, DUS
둥: TIKEUT-U-IEUNG, DUNG
둬: TIKEUT-WEO, DWEO
뒀: TIKEUT-WEO-SSANGSIOS, DWEOSS
뒈: TIKEUT-WE, DWE
뒝: TIKEUT-WE-IEUNG, DWENG
뒤: TIKEUT-WI, DWI
뒨: TIKEUT-WI-NIEUN, DWIN
뒬: TIKEUT-WI-RIEUL, DWIL
뒵: TIKEUT-WI-PIEUP, DWIB
뒷: TIKEUT-WI-SIOS, DWIS
뒹: TIKEUT-WI-IEUNG, DWING
듀: TIKEUT-YU, DYU
듄: TIKEUT-YU-NIEUN, DYUN
듈: TIKEUT-YU-RIEUL, DYUL
듐: TIKEUT-YU-MIEUM, DYUM
듕: TIKEUT-YU-IEUNG, DYUNG
드: TIKEUT-EU, DEU
득: TIKEUT-EU-KIYEOK, DEUG
든: TIKEUT-EU-NIEUN, DEUN
듣: TIKEUT-EU-TIKEUT, DEUD
들: TIKEUT-EU-RIEUL, DEUL
듦: TIKEUT-EU-RIEULMIEUM, DEULM
듬: TIKEUT-EU-MIEUM, DEUM
듭: TIKEUT-EU-PIEUP, DEUB
듯: TIKEUT-EU-SIOS, DEUS
등: TIKEUT-EU-IEUNG, DEUNG
듸: TIKEUT-YI, DYI
디: TIKEUT-I, DI
딕: TIKEUT-I-KIYEOK, DIG
딘: TIKEUT-I-NIEUN, DIN
딛: TIKEUT-I-TIKEUT, DID
딜: TIKEUT-I-RIEUL, DIL
딤: TIKEUT-I-MIEUM, DIM
딥: TIKEUT-I-PIEUP, DIB
딧: TIKEUT-I-SIOS, DIS
딨: TIKEUT-I-SSANGSIOS, DISS
딩: TIKEUT-I-IEUNG, DING
딪: TIKEUT-I-CIEUC, DIJ
따: SSANGTIKEUT-A, DDA
딱: SSANGTIKEUT-A-KIYEOK, DDAG
딴: SSANGTIKEUT-A-NIEUN, DDAN
딸: SSANGTIKEUT-A-RIEUL, DDAL
땀: SSANGTIKEUT-A-MIEUM, DDAM
땁: SSANGTIKEUT-A-PIEUP, DDAB
땃: SSANGTIKEUT-A-SIOS, DDAS
땄: SSANGTIKEUT-A-SSANGSIOS, DDASS
땅: SSANGTIKEUT-A-IEUNG, DDANG
땋: SSANGTIKEUT-A-HIEUH, DDAH
때: SSANGTIKEUT-AE, DDAE
땍: SSANGTIKEUT-AE-KIYEOK, DDAEG
땐: SSANGTIKEUT-AE-NIEUN, DDAEN
땔: SSANGTIKEUT-AE-RIEUL, DDAEL
땜: SSANGTIKEUT-AE-MIEUM, DDAEM
땝: SSANGTIKEUT-AE-PIEUP, DDAEB
땟: SSANGTIKEUT-AE-SIOS, DDAES
땠: SSANGTIKEUT-AE-SSANGSIOS, DDAESS
땡: SSANGTIKEUT-AE-IEUNG, DDAENG
떠: SSANGTIKEUT-EO, DDEO
떡: SSANGTIKEUT-EO-KIYEOK, DDEOG
떤: SSANGTIKEUT-EO-NIEUN, DDEON
떨: SSANGTIKEUT-EO-RIEUL, DDEOL
떪: SSANGTIKEUT-EO-RIEULMIEUM, DDEOLM
떫: SSANGTIKEUT-EO-RIEULPIEUP, DDEOLB
떰: SSANGTIKEUT-EO-MIEUM, DDEOM
떱: SSANGTIKEUT-EO-PIEUP, DDEOB
떳: SSANGTIKEUT-EO-SIOS, DDEOS
떴: SSANGTIKEUT-EO-SSANGSIOS, DDEOSS
떵: SSANGTIKEUT-EO-IEUNG, DDEONG
떻: SSANGTIKEUT-EO-HIEUH, DDEOH
떼: SSANGTIKEUT-E, DDE
떽: SSANGTIKEUT-E-KIYEOK, DDEG
뗀: SSANGTIKEUT-E-NIEUN, DDEN
뗄: SSANGTIKEUT-E-RIEUL, DDEL
뗌: SSANGTIKEUT-E-MIEUM, DDEM
뗍: SSANGTIKEUT-E-PIEUP, DDEB
뗏: SSANGTIKEUT-E-SIOS, DDES
뗐: SSANGTIKEUT-E-SSANGSIOS, DDESS
뗑: SSANGTIKEUT-E-IEUNG, DDENG
뗘: SSANGTIKEUT-YEO, DDYEO
뗬: SSANGTIKEUT-YEO-SSANGSIOS, DDYEOSS
또: SSANGTIKEUT-O, DDO
똑: SSANGTIKEUT-O-KIYEOK, DDOG
똔: SSANGTIKEUT-O-NIEUN, DDON
똘: SSANGTIKEUT-O-RIEUL, DDOL
똥: SSANGTIKEUT-O-IEUNG, DDONG
똬: SSANGTIKEUT-WA, DDWA
똴: SSANGTIKEUT-WA-RIEUL, DDWAL
뙈: SSANGTIKEUT-WAE, DDWAE
뙤: SSANGTIKEUT-OE, DDOE
뙨: SSANGTIKEUT-OE-NIEUN, DDOEN
뚜: SSANGTIKEUT-U, DDU
뚝: SSANGTIKEUT-U-KIYEOK, DDUG
뚠: SSANGTIKEUT-U-NIEUN, DDUN
뚤: SSANGTIKEUT-U-RIEUL, DDUL
뚫: SSANGTIKEUT-U-RIEULHIEUH, DDULH
뚬: SSANGTIKEUT-U-MIEUM, DDUM
뚱: SSANGTIKEUT-U-IEUNG, DDUNG
뛔: SSANGTIKEUT-WE, DDWE
뛰: SSANGTIKEUT-WI, DDWI
뛴: SSANGTIKEUT-WI-NIEUN, DDWIN
뛸: SSANGTIKEUT-WI-RIEUL, DDWIL
뜀: SSANGTIKEUT-WI-MIEUM, DDWIM
뜁: SSANGTIKEUT-WI-PIEUP, DDWIB
뜅: SSANGTIKEUT-WI-IEUNG, DDWING
뜨: SSANGTIKEUT-EU, DDEU
뜩: SSANGTIKEUT-EU-KIYEOK, DDEUG
뜬: SSANGTIKEUT-EU-NIEUN, DDEUN
뜯: SSANGTIKEUT-EU-TIKEUT, DDEUD
뜰: SSANGTIKEUT-EU-RIEUL, DDEUL
뜸: SSANGTIKEUT-EU-MIEUM, DDEUM
뜹: SSANGTIKEUT-EU-PIEUP, DDEUB
뜻: SSANGTIKEUT-EU-SIOS, DDEUS
띄: SSANGTIKEUT-YI, DDYI
띈: SSANGTIKEUT-YI-NIEUN, DDYIN
띌: SSANGTIKEUT-YI-RIEUL, DDYIL
띔: SSANGTIKEUT-YI-MIEUM, DDYIM
띕: SSANGTIKEUT-YI-PIEUP, DDYIB
띠: SSANGTIKEUT-I, DDI
띤: SSANGTIKEUT-I-NIEUN, DDIN
띨: SSANGTIKEUT-I-RIEUL, DDIL
띰: SSANGTIKEUT-I-MIEUM, DDIM
띱: SSANGTIKEUT-I-PIEUP, DDIB
띳: SSANGTIKEUT-I-SIOS, DDIS
띵: SSANGTIKEUT-I-IEUNG, DDING
라: RIEUL-A, RA
락: RIEUL-A-KIYEOK, RAG
란: RIEUL-A-NIEUN, RAN
랄: RIEUL-A-RIEUL, RAL
람: RIEUL-A-MIEUM, RAM
랍: RIEUL-A-PIEUP, RAB
랏: RIEUL-A-SIOS, RAS
랐: RIEUL-A-SSANGSIOS, RASS
랑: RIEUL-A-IEUNG, RANG
랒: RIEUL-A-CIEUC, RAJ
랖: RIEUL-A-PHIEUPH, RAP
랗: RIEUL-A-HIEUH, RAH
래: RIEUL-AE, RAE
랙: RIEUL-AE-KIYEOK, RAEG
랜: RIEUL-AE-NIEUN, RAEN
랠: RIEUL-AE-RIEUL, RAEL
램: RIEUL-AE-MIEUM, RAEM
랩: RIEUL-AE-PIEUP, RAEB
랫: RIEUL-AE-SIOS, RAES
랬: RIEUL-AE-SSANGSIOS, RAESS
랭: RIEUL-AE-IEUNG, RAENG
랴: RIEUL-YA, RYA
략: RIEUL-YA-KIYEOK, RYAG
랸: RIEUL-YA-NIEUN, RYAN
럇: RIEUL-YA-SIOS, RYAS
량: RIEUL-YA-IEUNG, RYANG
러: RIEUL-EO, REO
럭: RIEUL-EO-KIYEOK, REOG
런: RIEUL-EO-NIEUN, REON
럴: RIEUL-EO-RIEUL, REOL
럼: RIEUL-EO-MIEUM, REOM
럽: RIEUL-EO-PIEUP, REOB
럿: RIEUL-EO-SIOS, REOS
렀: RIEUL-EO-SSANGSIOS, REOSS
렁: RIEUL-EO-IEUNG, REONG
렇: RIEUL-EO-HIEUH, REOH
레: RIEUL-E, RE
렉: RIEUL-E-KIYEOK, REG
렌: RIEUL-E-NIEUN, REN
렐: RIEUL-E-RIEUL, REL
렘: RIEUL-E-MIEUM, REM
렙: RIEUL-E-PIEUP, REB
렛: RIEUL-E-SIOS, RES
렝: RIEUL-E-IEUNG, RENG
려: RIEUL-YEO, RYEO
력: RIEUL-YEO-KIYEOK, RYEOG
련: RIEUL-YEO-NIEUN, RYEON
렬: RIEUL-YEO-RIEUL, RYEOL
렴: RIEUL-YEO-MIEUM, RYEOM
렵: RIEUL-YEO-PIEUP, RYEOB
렷: RIEUL-YEO-SIOS, RYEOS
렸: RIEUL-YEO-SSANGSIOS, RYEOSS
령: RIEUL-YEO-IEUNG, RYEONG
례: RIEUL-YE, RYE
롄: RIEUL-YE-NIEUN, RYEN
롑: RIEUL-YE-PIEUP, RYEB
롓: RIEUL-YE-SIOS, RYES
로: RIEUL-O, RO
록: RIEUL-O-KIYEOK, ROG
론: RIEUL-O-NIEUN, RON
롤: RIEUL-O-RIEUL, ROL
롬: RIEUL-O-MIEUM, ROM
롭: RIEUL-O-PIEUP, ROB
롯: RIEUL-O-SIOS, ROS
롱: RIEUL-O-IEUNG, RONG
롸: RIEUL-WA, RWA
롼: RIEUL-WA-NIEUN, RWAN
뢍: RIEUL-WA-IEUNG, RWANG
뢨: RIEUL-WAE-SSANGSIOS, RWAESS
뢰: RIEUL-OE, ROE
뢴: RIEUL-OE-NIEUN, ROEN
뢸: RIEUL-OE-RIEUL, ROEL
룀: RIEUL-OE-MIEUM, ROEM
룁: RIEUL-OE-PIEUP, ROEB
룃: RIEUL-OE-SIOS, ROES
룅: RIEUL-OE-IEUNG, ROENG
료: RIEUL-YO, RYO
룐: RIEUL-YO-NIEUN, RYON
룔: RIEUL-YO-RIEUL, RYOL
룝: RIEUL-YO-PIEUP, RYOB
룟: RIEUL-YO-SIOS, RYOS
룡: RIEUL-YO-IEUNG, RYONG
루: RIEUL-U, RU
룩: RIEUL-U-KIYEOK, RUG
룬: RIEUL-U-NIEUN, RUN
룰: RIEUL-U-RIEUL, RUL
룸: RIEUL-U-MIEUM, RUM
룹: RIEUL-U-PIEUP, RUB
룻: RIEUL-U-SIOS, RUS
룽: RIEUL-U-IEUNG, RUNG
뤄: RIEUL-WEO, RWEO
뤘: RIEUL-WEO-SSANGSIOS, RWEOSS
뤠: RIEUL-WE, RWE
뤼: RIEUL-WI, RWI
뤽: RIEUL-WI-KIYEOK, RWIG
륀: RIEUL-WI-NIEUN, RWIN
륄: RIEUL-WI-RIEUL, RWIL
륌: RIEUL-WI-MIEUM, RWIM
륏: RIEUL-WI-SIOS, RWIS
륑: RIEUL-WI-IEUNG, RWING
류: RIEUL-YU, RYU
륙: RIEUL-YU-KIYEOK, RYUG
륜: RIEUL-YU-NIEUN, RYUN
률: RIEUL-YU-RIEUL, RYUL
륨: RIEUL-YU-MIEUM, RYUM
륩: RIEUL-YU-PIEUP, RYUB
륫: RIEUL-YU-SIOS, RYUS
륭: RIEUL-YU-IEUNG, RYUNG
르: RIEUL-EU, REU
륵: RIEUL-EU-KIYEOK, REUG
른: RIEUL-EU-NIEUN, REUN
를: RIEUL-EU-RIEUL, REUL
름: RIEUL-EU-MIEUM, REUM
릅: RIEUL-EU-PIEUP, REUB
릇: RIEUL-EU-SIOS, REUS
릉: RIEUL-EU-IEUNG, REUNG
릊: RIEUL-EU-CIEUC, REUJ
릍: RIEUL-EU-THIEUTH, REUT
릎: RIEUL-EU-PHIEUPH, REUP
리: RIEUL-I, RI
릭: RIEUL-I-KIYEOK, RIG
린: RIEUL-I-NIEUN, RIN
릴: RIEUL-I-RIEUL, RIL
림: RIEUL-I-MIEUM, RIM
립: RIEUL-I-PIEUP, RIB
릿: RIEUL-I-SIOS, RIS
링: RIEUL-I-IEUNG, RING
마: MIEUM-A, MA
막: MIEUM-A-KIYEOK, MAG
만: MIEUM-A-NIEUN, MAN
많: MIEUM-A-NIEUNHIEUH, MANH
맏: MIEUM-A-TIKEUT, MAD
말: MIEUM-A-RIEUL, MAL
맑: MIEUM-A-RIEULKIYEOK, MALG
맒: MIEUM-A-RIEULMIEUM, MALM
맘: MIEUM-A-MIEUM, MAM
맙: MIEUM-A-PIEUP, MAB
맛: MIEUM-A-SIOS, MAS
망: MIEUM-A-IEUNG, MANG
맞: MIEUM-A-CIEUC, MAJ
맡: MIEUM-A-THIEUTH, MAT
맣: MIEUM-A-HIEUH, MAH
매: MIEUM-AE, MAE
맥: MIEUM-AE-KIYEOK, MAEG
맨: MIEUM-AE-NIEUN, MAEN
맬: MIEUM-AE-RIEUL, MAEL
맴: MIEUM-AE-MIEUM, MAEM
맵: MIEUM-AE-PIEUP, MAEB
맷: MIEUM-AE-SIOS, MAES
맸: MIEUM-AE-SSANGSIOS, MAESS
맹: MIEUM-AE-IEUNG, MAENG
맺: MIEUM-AE-CIEUC, MAEJ
먀: MIEUM-YA, MYA
먁: MIEUM-YA-KIYEOK, MYAG
먈: MIEUM-YA-RIEUL, MYAL
먕: MIEUM-YA-IEUNG, MYANG
머: MIEUM-EO, MEO
먹: MIEUM-EO-KIYEOK, MEOG
먼: MIEUM-EO-NIEUN, MEON
멀: MIEUM-EO-RIEUL, MEOL
멂: MIEUM-EO-RIEULMIEUM, MEOLM
멈: MIEUM-EO-MIEUM, MEOM
멉: MIEUM-EO-PIEUP, MEOB
멋: MIEUM-EO-SIOS, MEOS
멍: MIEUM-EO-IEUNG, MEONG
멎: MIEUM-EO-CIEUC, MEOJ
멓: MIEUM-EO-HIEUH, MEOH
메: MIEUM-E, ME
멕: MIEUM-E-KIYEOK, MEG
멘: MIEUM-E-NIEUN, MEN
멜: MIEUM-E-RIEUL, MEL
멤: MIEUM-E-MIEUM, MEM
멥: MIEUM-E-PIEUP, MEB
멧: MIEUM-E-SIOS, MES
멨: MIEUM-E-SSANGSIOS, MESS
멩: MIEUM-E-IEUNG, MENG
며: MIEUM-YEO, MYEO
멱: MIEUM-YEO-KIYEOK, MYEOG
면: MIEUM-YEO-NIEUN, MYEON
멸: MIEUM-YEO-RIEUL, MYEOL
몃: MIEUM-YEO-SIOS, MYEOS
몄: MIEUM-YEO-SSANGSIOS, MYEOSS
명: MIEUM-YEO-IEUNG, MYEONG
몇: MIEUM-YEO-CHIEUCH, MYEOC
몌: MIEUM-YE, MYE
모: MIEUM-O, MO
목: MIEUM-O-KIYEOK, MOG
몫: MIEUM-O-KIYEOKSIOS, MOGS
몬: MIEUM-O-NIEUN, MON
몰: MIEUM-O-RIEUL, MOL
몲: MIEUM-O-RIEULMIEUM, MOLM
몸: MIEUM-O-MIEUM, MOM
몹: MIEUM-O-PIEUP, MOB
못: MIEUM-O-SIOS, MOS
몽: MIEUM-O-IEUNG, MONG
뫄: MIEUM-WA, MWA
뫈: MIEUM-WA-NIEUN, MWAN
뫘: MIEUM-WA-SSANGSIOS, MWASS
뫙: MIEUM-WA-IEUNG, MWANG
뫼: MIEUM-OE, MOE
묀: MIEUM-OE-NIEUN, MOEN
묄: MIEUM-OE-RIEUL, MOEL
묍: MIEUM-OE-PIEUP, MOEB
묏: MIEUM-OE-SIOS, MOES
묑: MIEUM-OE-IEUNG, MOENG
묘: MIEUM-YO, MYO
묜: MIEUM-YO-NIEUN, MYON
묠: MIEUM-YO-RIEUL, MYOL
묩: MIEUM-YO-PIEUP, MYOB
묫: MIEUM-YO-SIOS, MYOS
무: MIEUM-U, MU
묵: MIEUM-U-KIYEOK, MUG
묶: MIEUM-U-SSANGKIYEOK, MUGG
문: MIEUM-U-NIEUN, MUN
묻: MIEUM-U-TIKEUT, MUD
물: MIEUM-U-RIEUL, MUL
묽: MIEUM-U-RIEULKIYEOK, MULG
묾: MIEUM-U-RIEULMIEUM, MULM
뭄: MIEUM-U-MIEUM, MUM
뭅: MIEUM-U-PIEUP, MUB
뭇: MIEUM-U-SIOS, MUS
뭉: MIEUM-U-IEUNG, MUNG
뭍: MIEUM-U-THIEUTH, MUT
뭏: MIEUM-U-HIEUH, MUH
뭐: MIEUM-WEO, MWEO
뭔: MIEUM-WEO-NIEUN, MWEON
뭘: MIEUM-WEO-RIEUL, MWEOL
뭡: MIEUM-WEO-PIEUP, MWEOB
뭣: MIEUM-WEO-SIOS, MWEOS
뭬: MIEUM-WE, MWE
뮈: MIEUM-WI, MWI
뮌: MIEUM-WI-NIEUN, MWIN
뮐: MIEUM-WI-RIEUL, MWIL
뮤: MIEUM-YU, MYU
뮨: MIEUM-YU-NIEUN, MYUN
뮬: MIEUM-YU-RIEUL, MYUL
뮴: MIEUM-YU-MIEUM, MYUM
뮷: MIEUM-YU-SIOS, MYUS
므: MIEUM-EU, MEU
믄: MIEUM-EU-NIEUN, MEUN
믈: MIEUM-EU-RIEUL, MEUL
믐: MIEUM-EU-MIEUM, MEUM
믓: MIEUM-EU-SIOS, MEUS
미: MIEUM-I, MI
믹: MIEUM-I-KIYEOK, MIG
민: MIEUM-I-NIEUN, MIN
믿: MIEUM-I-TIKEUT, MID
밀: MIEUM-I-RIEUL, MIL
밂: MIEUM-I-RIEULMIEUM, MILM
밈: MIEUM-I-MIEUM, MIM
밉: MIEUM-I-PIEUP, MIB
밋: MIEUM-I-SIOS, MIS
밌: MIEUM-I-SSANGSIOS, MISS
밍: MIEUM-I-IEUNG, MING
및: MIEUM-I-CHIEUCH, MIC
밑: MIEUM-I-THIEUTH, MIT
바: PIEUP-A, BA
박: PIEUP-A-KIYEOK, BAG
밖: PIEUP-A-SSANGKIYEOK, BAGG
밗: PIEUP-A-KIYEOKSIOS, BAGS
반: PIEUP-A-NIEUN, BAN
받: PIEUP-A-TIKEUT, BAD
발: PIEUP-A-RIEUL, BAL
밝: PIEUP-A-RIEULKIYEOK, BALG
밞: PIEUP-A-RIEULMIEUM, BALM
밟: PIEUP-A-RIEULPIEUP, BALB
밤: PIEUP-A-MIEUM, BAM
밥: PIEUP-A-PIEUP, BAB
밧: PIEUP-A-SIOS, BAS
방: PIEUP-A-IEUNG, BANG
밭: PIEUP-A-THIEUTH, BAT
배: PIEUP-AE, BAE
백: PIEUP-AE-KIYEOK, BAEG
밴: PIEUP-AE-NIEUN, BAEN
밸: PIEUP-AE-RIEUL, BAEL
뱀: PIEUP-AE-MIEUM, BAEM
뱁: PIEUP-AE-PIEUP, BAEB
뱃: PIEUP-AE-SIOS, BAES
뱄: PIEUP-AE-SSANGSIOS, BAESS
뱅: PIEUP-AE-IEUNG, BAENG
뱉: PIEUP-AE-THIEUTH, BAET
뱌: PIEUP-YA, BYA
뱍: PIEUP-YA-KIYEOK, BYAG
뱐: PIEUP-YA-NIEUN, BYAN
뱝: PIEUP-YA-PIEUP, BYAB
버: PIEUP-EO, BEO
벅: PIEUP-EO-KIYEOK, BEOG
번: PIEUP-EO-NIEUN, BEON
벋: PIEUP-EO-TIKEUT, BEOD
벌: PIEUP-EO-RIEUL, BEOL
벎: PIEUP-EO-RIEULMIEUM, BEOLM
범: PIEUP-EO-MIEUM, BEOM
법: PIEUP-EO-PIEUP, BEOB
벗: PIEUP-EO-SIOS, BEOS
벙: PIEUP-EO-IEUNG, BEONG
벚: PIEUP-EO-CIEUC, BEOJ
베: PIEUP-E, BE
벡: PIEUP-E-KIYEOK, BEG
벤: PIEUP-E-NIEUN, BEN
벧: PIEUP-E-TIKEUT, BED
벨: PIEUP-E-RIEUL, BEL
벰: PIEUP-E-MIEUM, BEM
벱: PIEUP-E-PIEUP, BEB
벳: PIEUP-E-SIOS, BES
벴: PIEUP-E-SSANGSIOS, BESS
벵: PIEUP-E-IEUNG, BENG
벼: PIEUP-YEO, BYEO
벽: PIEUP-YEO-KIYEOK, BYEOG
변: PIEUP-YEO-NIEUN, BYEON
별: PIEUP-YEO-RIEUL, BYEOL
볍: PIEUP-YEO-PIEUP, BYEOB
볏: PIEUP-YEO-SIOS, BYEOS
볐: PIEUP-YEO-SSANGSIOS, BYEOSS
병: PIEUP-YEO-IEUNG, BYEONG
볕: PIEUP-YEO-THIEUTH, BYEOT
볘: PIEUP-YE, BYE
볜: PIEUP-YE-NIEUN, BYEN
보: PIEUP-O, BO
복: PIEUP-O-KIYEOK, BOG
볶: PIEUP-O-SSANGKIYEOK, BOGG
본: PIEUP-O-NIEUN, BON
볼: PIEUP-O-RIEUL, BOL
봄: PIEUP-O-MIEUM, BOM
봅: PIEUP-O-PIEUP, BOB
봇: PIEUP-O-SIOS, BOS
봉: PIEUP-O-IEUNG, BONG
봐: PIEUP-WA, BWA
봔: PIEUP-WA-NIEUN, BWAN
봤: PIEUP-WA-SSANGSIOS, BWASS
봬: PIEUP-WAE, BWAE
뵀: PIEUP-WAE-SSANGSIOS, BWAESS
뵈: PIEUP-OE, BOE
뵉: PIEUP-OE-KIYEOK, BOEG
뵌: PIEUP-OE-NIEUN, BOEN
뵐: PIEUP-OE-RIEUL, BOEL
뵘: PIEUP-OE-MIEUM, BOEM
뵙: PIEUP-OE-PIEUP, BOEB
뵤: PIEUP-YO, BYO
뵨: PIEUP-YO-NIEUN, BYON
부: PIEUP-U, BU
북: PIEUP-U-KIYEOK, BUG
분: PIEUP-U-NIEUN, BUN
붇: PIEUP-U-TIKEUT, BUD
불: PIEUP-U-RIEUL, BUL
붉: PIEUP-U-RIEULKIYEOK, BULG
붊: PIEUP-U-RIEULMIEUM, BULM
붐: PIEUP-U-MIEUM, BUM
붑: PIEUP-U-PIEUP, BUB
붓: PIEUP-U-SIOS, BUS
붕: PIEUP-U-IEUNG, BUNG
붙: PIEUP-U-THIEUTH, BUT
붚: PIEUP-U-PHIEUPH, BUP
붜: PIEUP-WEO, BWEO
붤: PIEUP-WEO-RIEUL, BWEOL
붰: PIEUP-WEO-SSANGSIOS, BWEOSS
붸: PIEUP-WE, BWE
뷔: PIEUP-WI, BWI
뷕: PIEUP-WI-KIYEOK, BWIG
뷘: PIEUP-WI-NIEUN, BWIN
뷜: PIEUP-WI-RIEUL, BWIL
뷩: PIEUP-WI-IEUNG, BWING
뷰: PIEUP-YU, BYU
뷴: PIEUP-YU-NIEUN, BYUN
뷸: PIEUP-YU-RIEUL, BYUL
븀: PIEUP-YU-MIEUM, BYUM
븃: PIEUP-YU-SIOS, BYUS
븅: PIEUP-YU-IEUNG, BYUNG
브: PIEUP-EU, BEU
븍: PIEUP-EU-KIYEOK, BEUG
븐: PIEUP-EU-NIEUN, BEUN
블: PIEUP-EU-RIEUL, BEUL
븜: PIEUP-EU-MIEUM, BEUM
븝: PIEUP-EU-PIEUP, BEUB
븟: PIEUP-EU-SIOS, BEUS
비: PIEUP-I, BI
빅: PIEUP-I-KIYEOK, BIG
빈: PIEUP-I-NIEUN, BIN
빌: PIEUP-I-RIEUL, BIL
빎: PIEUP-I-RIEULMIEUM, BILM
빔: PIEUP-I-MIEUM, BIM
빕: PIEUP-I-PIEUP, BIB
빗: PIEUP-I-SIOS, BIS
빙: PIEUP-I-IEUNG, BING
빚: PIEUP-I-CIEUC, BIJ
빛: PIEUP-I-CHIEUCH, BIC
빠: SSANGPIEUP-A, BBA
빡: SSANGPIEUP-A-KIYEOK, BBAG
빤: SSANGPIEUP-A-NIEUN, BBAN
빨: SSANGPIEUP-A-RIEUL, BBAL
빪: SSANGPIEUP-A-RIEULMIEUM, BBALM
빰: SSANGPIEUP-A-MIEUM, BBAM
빱: SSANGPIEUP-A-PIEUP, BBAB
빳: SSANGPIEUP-A-SIOS, BBAS
빴: SSANGPIEUP-A-SSANGSIOS, BBASS
빵: SSANGPIEUP-A-IEUNG, BBANG
빻: SSANGPIEUP-A-HIEUH, BBAH
빼: SSANGPIEUP-AE, BBAE
빽: SSANGPIEUP-AE-KIYEOK, BBAEG
뺀: SSANGPIEUP-AE-NIEUN, BBAEN
뺄: SSANGPIEUP-AE-RIEUL, BBAEL
뺌: SSANGPIEUP-AE-MIEUM, BBAEM
뺍: SSANGPIEUP-AE-PIEUP, BBAEB
뺏: SSANGPIEUP-AE-SIOS, BBAES
뺐: SSANGPIEUP-AE-SSANGSIOS, BBAESS
뺑: SSANGPIEUP-AE-IEUNG, BBAENG
뺘: SSANGPIEUP-YA, BBYA
뺙: SSANGPIEUP-YA-KIYEOK, BBYAG
뺨: SSANGPIEUP-YA-MIEUM, BBYAM
뻐: SSANGPIEUP-EO, BBEO
뻑: SSANGPIEUP-EO-KIYEOK, BBEOG
뻔: SSANGPIEUP-EO-NIEUN, BBEON
뻗: SSANGPIEUP-EO-TIKEUT, BBEOD
뻘: SSANGPIEUP-EO-RIEUL, BBEOL
뻠: SSANGPIEUP-EO-MIEUM, BBEOM
뻣: SSANGPIEUP-EO-SIOS, BBEOS
뻤: SSANGPIEUP-EO-SSANGSIOS, BBEOSS
뻥: SSANGPIEUP-EO-IEUNG, BBEONG
뻬: SSANGPIEUP-E, BBE
뼁: SSANGPIEUP-E-IEUNG, BBENG
뼈: SSANGPIEUP-YEO, BBYEO
뼉: SSANGPIEUP-YEO-KIYEOK, BBYEOG
뼘: SSANGPIEUP-YEO-MIEUM, BBYEOM
뼙: SSANGPIEUP-YEO-PIEUP, BBYEOB
뼛: SSANGPIEUP-YEO-SIOS, BBYEOS
뼜: SSANGPIEUP-YEO-SSANGSIOS, BBYEOSS
뼝: SSANGPIEUP-YEO-IEUNG, BBYEONG
뽀: SSANGPIEUP-O, BBO
뽁: SSANGPIEUP-O-KIYEOK, BBOG
뽄: SSANGPIEUP-O-NIEUN, BBON
뽈: SSANGPIEUP-O-RIEUL, BBOL
뽐: SSANGPIEUP-O-MIEUM, BBOM
뽑: SSANGPIEUP-O-PIEUP, BBOB
뽕: SSANGPIEUP-O-IEUNG, BBONG
뾔: SSANGPIEUP-OE, BBOE
뾰: SSANGPIEUP-YO, BBYO
뿅: SSANGPIEUP-YO-IEUNG, BBYONG
뿌: SSANGPIEUP-U, BBU
뿍: SSANGPIEUP-U-KIYEOK, BBUG
뿐: SSANGPIEUP-U-NIEUN, BBUN
뿔: SSANGPIEUP-U-RIEUL, BBUL
뿜: SSANGPIEUP-U-MIEUM, BBUM
뿟: SSANGPIEUP-U-SIOS, BBUS
뿡: SSANGPIEUP-U-IEUNG, BBUNG
쀼: SSANGPIEUP-YU, BBYU
쁑: SSANGPIEUP-YU-IEUNG, BBYUNG
쁘: SSANGPIEUP-EU, BBEU
쁜: SSANGPIEUP-EU-NIEUN, BBEUN
쁠: SSANGPIEUP-EU-RIEUL, BBEUL
쁨: SSANGPIEUP-EU-MIEUM, BBEUM
쁩: SSANGPIEUP-EU-PIEUP, BBEUB
삐: SSANGPIEUP-I, BBI
삑: SSANGPIEUP-I-KIYEOK, BBIG
삔: SSANGPIEUP-I-NIEUN, BBIN
삘: SSANGPIEUP-I-RIEUL, BBIL
삠: SSANGPIEUP-I-MIEUM, BBIM
삡: SSANGPIEUP-I-PIEUP, BBIB
삣: SSANGPIEUP-I-SIOS, BBIS
삥: SSANGPIEUP-I-IEUNG, BBING
사: SIOS-A, SA
삭: SIOS-A-KIYEOK, SAG
삯: SIOS-A-KIYEOKSIOS, SAGS
산: SIOS-A-NIEUN, SAN
삳: SIOS-A-TIKEUT, SAD
살: SIOS-A-RIEUL, SAL
삵: SIOS-A-RIEULKIYEOK, SALG
삶: SIOS-A-RIEULMIEUM, SALM
삼: SIOS-A-MIEUM, SAM
삽: SIOS-A-PIEUP, SAB
삿: SIOS-A-SIOS, SAS
샀: SIOS-A-SSANGSIOS, SASS
상: SIOS-A-IEUNG, SANG
샅: SIOS-A-THIEUTH, SAT
새: SIOS-AE, SAE
색: SIOS-AE-KIYEOK, SAEG
샌: SIOS-AE-NIEUN, SAEN
샐: SIOS-AE-RIEUL, SAEL
샘: SIOS-AE-MIEUM, SAEM
샙: SIOS-AE-PIEUP, SAEB
샛: SIOS-AE-SIOS, SAES
샜: SIOS-AE-SSANGSIOS, SAESS
생: SIOS-AE-IEUNG, SAENG
샤: SIOS-YA, SYA
샥: SIOS-YA-KIYEOK, SYAG
샨: SIOS-YA-NIEUN, SYAN
샬: SIOS-YA-RIEUL, SYAL
샴: SIOS-YA-MIEUM, SYAM
샵: SIOS-YA-PIEUP, SYAB
샷: SIOS-YA-SIOS, SYAS
샹: SIOS-YA-IEUNG, SYANG
섀: SIOS-YAE, SYAE
섄: SIOS-YAE-NIEUN, SYAEN
섈: SIOS-YAE-RIEUL, SYAEL
섐: SIOS-YAE-MIEUM, SYAEM
섕: SIOS-YAE-IEUNG, SYAENG
서: SIOS-EO, SEO
석: SIOS-EO-KIYEOK, SEOG
섞: SIOS-EO-SSANGKIYEOK, SEOGG
섟: SIOS-EO-KIYEOKSIOS, SEOGS
선: SIOS-EO-NIEUN, SEON
섣: SIOS-EO-TIKEUT, SEOD
설: SIOS-EO-RIEUL, SEOL
섦: SIOS-EO-RIEULMIEUM, SEOLM
섧: SIOS-EO-RIEULPIEUP, SEOLB
섬: SIOS-EO-MIEUM, SEOM
섭: SIOS-EO-PIEUP, SEOB
섯: SIOS-EO-SIOS, SEOS
섰: SIOS-EO-SSANGSIOS, SEOSS
성: SIOS-EO-IEUNG, SEONG
섶: SIOS-EO-PHIEUPH, SEOP
세: SIOS-E, SE
섹: SIOS-E-KIYEOK, SEG
센: SIOS-E-NIEUN, SEN
셀: SIOS-E-RIEUL, SEL
셈: SIOS-E-MIEUM, SEM
셉: SIOS-E-PIEUP, SEB
셋: SIOS-E-SIOS, SES
셌: SIOS-E-SSANGSIOS, SESS
셍: SIOS-E-IEUNG, SENG
셔: SIOS-YEO, SYEO
셕: SIOS-YEO-KIYEOK, SYEOG
션: SIOS-YEO-NIEUN, SYEON
셜: SIOS-YEO-RIEUL, SYEOL
셤: SIOS-YEO-MIEUM, SYEOM
셥: SIOS-YEO-PIEUP, SYEOB
셧: SIOS-YEO-SIOS, SYEOS
셨: SIOS-YEO-SSANGSIOS, SYEOSS
셩: SIOS-YEO-IEUNG, SYEONG
셰: SIOS-YE, SYE
셴: SIOS-YE-NIEUN, SYEN
셸: SIOS-YE-RIEUL, SYEL
솅: SIOS-YE-IEUNG, SYENG
소: SIOS-O, SO
속: SIOS-O-KIYEOK, SOG
솎: SIOS-O-SSANGKIYEOK, SOGG
손: SIOS-O-NIEUN, SON
솔: SIOS-O-RIEUL, SOL
솖: SIOS-O-RIEULMIEUM, SOLM
솜: SIOS-O-MIEUM, SOM
솝: SIOS-O-PIEUP, SOB
솟: SIOS-O-SIOS, SOS
송: SIOS-O-IEUNG, SONG
솥: SIOS-O-THIEUTH, SOT
솨: SIOS-WA, SWA
솩: SIOS-WA-KIYEOK, SWAG
솬: SIOS-WA-NIEUN, SWAN
솰: SIOS-WA-RIEUL, SWAL
솽: SIOS-WA-IEUNG, SWANG
쇄: SIOS-WAE, SWAE
쇈: SIOS-WAE-NIEUN, SWAEN
쇌: SIOS-WAE-RIEUL, SWAEL
쇔: SIOS-WAE-MIEUM, SWAEM
쇗: SIOS-WAE-SIOS, SWAES
쇘: SIOS-WAE-SSANGSIOS, SWAESS
쇠: SIOS-OE, SOE
쇤: SIOS-OE-NIEUN, SOEN
쇨: SIOS-OE-RIEUL, SOEL
쇰: SIOS-OE-MIEUM, SOEM
쇱: SIOS-OE-PIEUP, SOEB
쇳: SIOS-OE-SIOS, SOES
쇼: SIOS-YO, SYO
쇽: SIOS-YO-KIYEOK, SYOG
숀: SIOS-YO-NIEUN, SYON
숄: SIOS-YO-RIEUL, SYOL
숌: SIOS-YO-MIEUM, SYOM
숍: SIOS-YO-PIEUP, SYOB
숏: SIOS-YO-SIOS, SYOS
숑: SIOS-YO-IEUNG, SYONG
수: SIOS-U, SU
숙: SIOS-U-KIYEOK, SUG
순: SIOS-U-NIEUN, SUN
숟: SIOS-U-TIKEUT, SUD
술: SIOS-U-RIEUL, SUL
숨: SIOS-U-MIEUM, SUM
숩: SIOS-U-PIEUP, SUB
숫: SIOS-U-SIOS, SUS
숭: SIOS-U-IEUNG, SUNG
숯: SIOS-U-CHIEUCH, SUC
숱: SIOS-U-THIEUTH, SUT
숲: SIOS-U-PHIEUPH, SUP
숴: SIOS-WEO, SWEO
쉈: SIOS-WEO-SSANGSIOS, SWEOSS
쉐: SIOS-WE, SWE
쉑: SIOS-WE-KIYEOK, SWEG
쉔: SIOS-WE-NIEUN, SWEN
쉘: SIOS-WE-RIEUL, SWEL
쉠: SIOS-WE-MIEUM, SWEM
쉥: SIOS-WE-IEUNG, SWENG
쉬: SIOS-WI, SWI
쉭: SIOS-WI-KIYEOK, SWIG
쉰: SIOS-WI-NIEUN, SWIN
쉴: SIOS-WI-RIEUL, SWIL
쉼: SIOS-WI-MIEUM, SWIM
쉽: SIOS-WI-PIEUP, SWIB
쉿: SIOS-WI-SIOS, SWIS
슁: SIOS-WI-IEUNG, SWING
슈: SIOS-YU, SYU
슉: SIOS-YU-KIYEOK, SYUG
슐: SIOS-YU-RIEUL, SYUL
슘: SIOS-YU-MIEUM, SYUM
슛: SIOS-YU-SIOS, SYUS
슝: SIOS-YU-IEUNG, SYUNG
스: SIOS-EU, SEU
슥: SIOS-EU-KIYEOK, SEUG
슨: SIOS-EU-NIEUN, SEUN
슬: SIOS-EU-RIEUL, SEUL
슭: SIOS-EU-RIEULKIYEOK, SEULG
슴: SIOS-EU-MIEUM, SEUM
습: SIOS-EU-PIEUP, SEUB
슷: SIOS-EU-SIOS, SEUS
승: SIOS-EU-IEUNG, SEUNG
시: SIOS-I, SI
식: SIOS-I-KIYEOK, SIG
신: SIOS-I-NIEUN, SIN
싣: SIOS-I-TIKEUT, SID
실: SIOS-I-RIEUL, SIL
싫: SIOS-I-RIEULHIEUH, SILH
심: SIOS-I-MIEUM, SIM
십: SIOS-I-PIEUP, SIB
싯: SIOS-I-SIOS, SIS
싱: SIOS-I-IEUNG, SING
싶: SIOS-I-PHIEUPH, SIP
싸: SSANGSIOS-A, SSA
싹: SSANGSIOS-A-KIYEOK, SSAG
싻: SSANGSIOS-A-KIYEOKSIOS, SSAGS
싼: SSANGSIOS-A-NIEUN, SSAN
쌀: SSANGSIOS-A-RIEUL, SSAL
쌈: SSANGSIOS-A-MIEUM, SSAM
쌉: SSANGSIOS-A-PIEUP, SSAB
쌌: SSANGSIOS-A-SSANGSIOS, SSASS
쌍: SSANGSIOS-A-IEUNG, SSANG
쌓: SSANGSIOS-A-HIEUH, SSAH
쌔: SSANGSIOS-AE, SSAE
쌕: SSANGSIOS-AE-KIYEOK, SSAEG
쌘: SSANGSIOS-AE-NIEUN, SSAEN
쌜: SSANGSIOS-AE-RIEUL, SSAEL
쌤: SSANGSIOS-AE-MIEUM, SSAEM
쌥: SSANGSIOS-AE-PIEUP, SSAEB
쌨: SSANGSIOS-AE-SSANGSIOS, SSAESS
쌩: SSANGSIOS-AE-IEUNG, SSAENG
썅: SSANGSIOS-YA-IEUNG, SSYANG
써: SSANGSIOS-EO, SSEO
썩: SSANGSIOS-EO-KIYEOK, SSEOG
썬: SSANGSIOS-EO-NIEUN, SSEON
썰: SSANGSIOS-EO-RIEUL, SSEOL
썲: SSANGSIOS-EO-RIEULMIEUM, SSEOLM
썸: SSANGSIOS-EO-MIEUM, SSEOM
썹: SSANGSIOS-EO-PIEUP, SSEOB
썼: SSANGSIOS-EO-SSANGSIOS, SSEOSS
썽: SSANGSIOS-EO-IEUNG, SSEONG
쎄: SSANGSIOS-E, SSE
쎈: SSANGSIOS-E-NIEUN, SSEN
쎌: SSANGSIOS-E-RIEUL, SSEL
쏀: SSANGSIOS-YE-NIEUN, SSYEN
쏘: SSANGSIOS-O, SSO
쏙: SSANGSIOS-O-KIYEOK, SSOG
쏜: SSANGSIOS-O-NIEUN, SSON
쏟: SSANGSIOS-O-TIKEUT, SSOD
쏠: SSANGSIOS-O-RIEUL, SSOL
쏢: SSANGSIOS-O-RIEULMIEUM, SSOLM
쏨: SSANGSIOS-O-MIEUM, SSOM
쏩: SSANGSIOS-O-PIEUP, SSOB
쏭: SSANGSIOS-O-IEUNG, SSONG
쏴: SSANGSIOS-WA, SSWA
쏵: SSANGSIOS-WA-KIYEOK, SSWAG
쏸: SSANGSIOS-WA-NIEUN, SSWAN
쐈: SSANGSIOS-WA-SSANGSIOS, SSWASS
쐐: SSANGSIOS-WAE, SSWAE
쐤: SSANGSIOS-WAE-SSANGSIOS, SSWAESS
쐬: SSANGSIOS-OE, SSOE
쐰: SSANGSIOS-OE-NIEUN, SSOEN
쐴: SSANGSIOS-OE-RIEUL, SSOEL
쐼: SSANGSIOS-OE-MIEUM, SSOEM
쐽: SSANGSIOS-OE-PIEUP, SSOEB
쑈: SSANGSIOS-YO, SSYO
쑤: SSANGSIOS-U, SSU
쑥: SSANGSIOS-U-KIYEOK, SSUG
쑨: SSANGSIOS-U-NIEUN, SSUN
쑬: SSANGSIOS-U-RIEUL, SSUL
쑴: SSANGSIOS-U-MIEUM, SSUM
쑵: SSANGSIOS-U-PIEUP, SSUB
쑹: SSANGSIOS-U-IEUNG, SSUNG
쒀: SSANGSIOS-WEO, SSWEO
쒔: SSANGSIOS-WEO-SSANGSIOS, SSWEOSS
쒜: SSANGSIOS-WE, SSWE
쒸: SSANGSIOS-WI, SSWI
쒼: SSANGSIOS-WI-NIEUN, SSWIN
쓩: SSANGSIOS-YU-IEUNG, SSYUNG
쓰: SSANGSIOS-EU, SSEU
쓱: SSANGSIOS-EU-KIYEOK, SSEUG
쓴: SSANGSIOS-EU-NIEUN, SSEUN
쓸: SSANGSIOS-EU-RIEUL, SSEUL
쓺: SSANGSIOS-EU-RIEULMIEUM, SSEULM
쓿: SSANGSIOS-EU-RIEULHIEUH, SSEULH
씀: SSANGSIOS-EU-MIEUM, SSEUM
씁: SSANGSIOS-EU-PIEUP, SSEUB
씌: SSANGSIOS-YI, SSYI
씐: SSANGSIOS-YI-NIEUN, SSYIN
씔: SSANGSIOS-YI-RIEUL, SSYIL
씜: SSANGSIOS-YI-MIEUM, SSYIM
씨: SSANGSIOS-I, SSI
씩: SSANGSIOS-I-KIYEOK, SSIG
씬: SSANGSIOS-I-NIEUN, SSIN
씰: SSANGSIOS-I-RIEUL, SSIL
씸: SSANGSIOS-I-MIEUM, SSIM
씹: SSANGSIOS-I-PIEUP, SSIB
씻: SSANGSIOS-I-SIOS, SSIS
씽: SSANGSIOS-I-IEUNG, SSING
아: IEUNG-A, A
악: IEUNG-A-KIYEOK, AG
안: IEUNG-A-NIEUN, AN
앉: IEUNG-A-NIEUNCIEUC, ANJ
않: IEUNG-A-NIEUNHIEUH, ANH
알: IEUNG-A-RIEUL, AL
앍: IEUNG-A-RIEULKIYEOK, ALG
앎: IEUNG-A-RIEULMIEUM, ALM
앓: IEUNG-A-RIEULHIEUH, ALH
암: IEUNG-A-MIEUM, AM
압: IEUNG-A-PIEUP, AB
앗: IEUNG-A-SIOS, AS
았: IEUNG-A-SSANGSIOS, ASS
앙: IEUNG-A-IEUNG, ANG
앝: IEUNG-A-THIEUTH, AT
앞: IEUNG-A-PHIEUPH, AP
애: IEUNG-AE, AE
액: IEUNG-AE-KIYEOK, AEG
앤: IEUNG-AE-NIEUN, AEN
앨: IEUNG-AE-RIEUL, AEL
앰: IEUNG-AE-MIEUM, AEM
앱: IEUNG-AE-PIEUP, AEB
앳: IEUNG-AE-SIOS, AES
앴: IEUNG-AE-SSANGSIOS, AESS
앵: IEUNG-AE-IEUNG, AENG
야: IEUNG-YA, YA
약: IEUNG-YA-KIYEOK, YAG
얀: IEUNG-YA-NIEUN, YAN
얄: IEUNG-YA-RIEUL, YAL
얇: IEUNG-YA-RIEULPIEUP, YALB
얌: IEUNG-YA-MIEUM, YAM
얍: IEUNG-YA-PIEUP, YAB
얏: IEUNG-YA-SIOS, YAS
양: IEUNG-YA-IEUNG, YANG
얕: IEUNG-YA-THIEUTH, YAT
얗: IEUNG-YA-HIEUH, YAH
얘: IEUNG-YAE, YAE
얜: IEUNG-YAE-NIEUN, YAEN
얠: IEUNG-YAE-RIEUL, YAEL
얩: IEUNG-YAE-PIEUP, YAEB
어: IEUNG-EO, EO
억: IEUNG-EO-KIYEOK, EOG
언: IEUNG-EO-NIEUN, EON
얹: IEUNG-EO-NIEUNCIEUC, EONJ
얻: IEUNG-EO-TIKEUT, EOD
얼: IEUNG-EO-RIEUL, EOL
얽: IEUNG-EO-RIEULKIYEOK, EOLG
얾: IEUNG-EO-RIEULMIEUM, EOLM
엄: IEUNG-EO-MIEUM, EOM
업: IEUNG-EO-PIEUP, EOB
없: IEUNG-EO-PIEUPSIOS, EOBS
엇: IEUNG-EO-SIOS, EOS
었: IEUNG-EO-SSANGSIOS, EOSS
엉: IEUNG-EO-IEUNG, EONG
엊: IEUNG-EO-CIEUC, EOJ
엌: IEUNG-EO-KHIEUKH, EOK
엎: IEUNG-EO-PHIEUPH, EOP
에: IEUNG-E, E
엑: IEUNG-E-KIYEOK, EG
엔: IEUNG-E-NIEUN, EN
엘: IEUNG-E-RIEUL, EL
엠: IEUNG-E-MIEUM, EM
엡: IEUNG-E-PIEUP, EB
엣: IEUNG-E-SIOS, ES
엥: IEUNG-E-IEUNG, ENG
여: IEUNG-YEO, YEO
역: IEUNG-YEO-KIYEOK, YEOG
엮: IEUNG-YEO-SSANGKIYEOK, YEOGG
연: IEUNG-YEO-NIEUN, YEON
열: IEUNG-YEO-RIEUL, YEOL
엶: IEUNG-YEO-RIEULMIEUM, YEOLM
엷: IEUNG-YEO-RIEULPIEUP, YEOLB
염: IEUNG-YEO-MIEUM, YEOM
엽: IEUNG-YEO-PIEUP, YEOB
엾: IEUNG-YEO-PIEUPSIOS, YEOBS
엿: IEUNG-YEO-SIOS, YEOS
였: IEUNG-YEO-SSANGSIOS, YEOSS
영: IEUNG-YEO-IEUNG, YEONG
옅: IEUNG-YEO-THIEUTH, YEOT
옆: IEUNG-YEO-PHIEUPH, YEOP
옇: IEUNG-YEO-HIEUH, YEOH
예: IEUNG-YE, YE
옌: IEUNG-YE-NIEUN, YEN
옐: IEUNG-YE-RIEUL, YEL
옘: IEUNG-YE-MIEUM, YEM
옙: IEUNG-YE-PIEUP, YEB
옛: IEUNG-YE-SIOS, YES
옜: IEUNG-YE-SSANGSIOS, YESS
오: IEUNG-O, O
옥: IEUNG-O-KIYEOK, OG
온: IEUNG-O-NIEUN, ON
올: IEUNG-O-RIEUL, OL
옭: IEUNG-O-RIEULKIYEOK, OLG
옮: IEUNG-O-RIEULMIEUM, OLM
옰: IEUNG-O-RIEULSIOS, OLS
옳: IEUNG-O-RIEULHIEUH, OLH
옴: IEUNG-O-MIEUM, OM
옵: IEUNG-O-PIEUP, OB
옷: IEUNG-O-SIOS, OS
옹: IEUNG-O-IEUNG, ONG
옻: IEUNG-O-CHIEUCH, OC
와: IEUNG-WA, WA
왁: IEUNG-WA-KIYEOK, WAG
완: IEUNG-WA-NIEUN, WAN
왈: IEUNG-WA-RIEUL, WAL
왐: IEUNG-WA-MIEUM, WAM
왑: IEUNG-WA-PIEUP, WAB
왓: IEUNG-WA-SIOS, WAS
왔: IEUNG-WA-SSANGSIOS, WASS
왕: IEUNG-WA-IEUNG, WANG
왜: IEUNG-WAE, WAE
왝: IEUNG-WAE-KIYEOK, WAEG
왠: IEUNG-WAE-NIEUN, WAEN
왬: IEUNG-WAE-MIEUM, WAEM
왯: IEUNG-WAE-SIOS, WAES
왱: IEUNG-WAE-IEUNG, WAENG
외: IEUNG-OE, OE
왹: IEUNG-OE-KIYEOK, OEG
왼: IEUNG-OE-NIEUN, OEN
욀: IEUNG-OE-RIEUL, OEL
욈: IEUNG-OE-MIEUM, OEM
욉: IEUNG-OE-PIEUP, OEB
욋: IEUNG-OE-SIOS, OES
욍: IEUNG-OE-IEUNG, OENG
요: IEUNG-YO, YO
욕: IEUNG-YO-KIYEOK, YOG
욘: IEUNG-YO-NIEUN, YON
욜: IEUNG-YO-RIEUL, YOL
욤: IEUNG-YO-MIEUM, YOM
욥: IEUNG-YO-PIEUP, YOB
욧: IEUNG-YO-SIOS, YOS
용: IEUNG-YO-IEUNG, YONG
우: IEUNG-U, U
욱: IEUNG-U-KIYEOK, UG
운: IEUNG-U-NIEUN, UN
울: IEUNG-U-RIEUL, UL
욹: IEUNG-U-RIEULKIYEOK, ULG
욺: IEUNG-U-RIEULMIEUM, ULM
움: IEUNG-U-MIEUM, UM
웁: IEUNG-U-PIEUP, UB
웃: IEUNG-U-SIOS, US
웅: IEUNG-U-IEUNG, UNG
워: IEUNG-WEO, WEO
웍: IEUNG-WEO-KIYEOK, WEOG
원: IEUNG-WEO-NIEUN, WEON
월: IEUNG-WEO-RIEUL, WEOL
웜: IEUNG-WEO-MIEUM, WEOM
웝: IEUNG-WEO-PIEUP, WEOB
웠: IEUNG-WEO-SSANGSIOS, WEOSS
웡: IEUNG-WEO-IEUNG, WEONG
웨: IEUNG-WE, WE
웩: IEUNG-WE-KIYEOK, WEG
웬: IEUNG-WE-NIEUN, WEN
웰: IEUNG-WE-RIEUL, WEL
웸: IEUNG-WE-MIEUM, WEM
웹: IEUNG-WE-PIEUP, WEB
웽: IEUNG-WE-IEUNG, WENG
위: IEUNG-WI, WI
윅: IEUNG-WI-KIYEOK, WIG
윈: IEUNG-WI-NIEUN, WIN
윌: IEUNG-WI-RIEUL, WIL
윔: IEUNG-WI-MIEUM, WIM
윕: IEUNG-WI-PIEUP, WIB
윗: IEUNG-WI-SIOS, WIS
윙: IEUNG-WI-IEUNG, WING
유: IEUNG-YU, YU
육: IEUNG-YU-KIYEOK, YUG
윤: IEUNG-YU-NIEUN, YUN
율: IEUNG-YU-RIEUL, YUL
윰: IEUNG-YU-MIEUM, YUM
윱: IEUNG-YU-PIEUP, YUB
윳: IEUNG-YU-SIOS, YUS
융: IEUNG-YU-IEUNG, YUNG
윷: IEUNG-YU-CHIEUCH, YUC
으: IEUNG-EU, EU
윽: IEUNG-EU-KIYEOK, EUG
은: IEUNG-EU-NIEUN, EUN
을: IEUNG-EU-RIEUL, EUL
읊: IEUNG-EU-RIEULPHIEUPH, EULP
음: IEUNG-EU-MIEUM, EUM
읍: IEUNG-EU-PIEUP, EUB
읏: IEUNG-EU-SIOS, EUS
응: IEUNG-EU-IEUNG, EUNG
읒: IEUNG-EU-CIEUC, EUJ
읓: IEUNG-EU-CHIEUCH, EUC
읔: IEUNG-EU-KHIEUKH, EUK
읕: IEUNG-EU-THIEUTH, EUT
읖: IEUNG-EU-PHIEUPH, EUP
읗: IEUNG-EU-HIEUH, EUH
의: IEUNG-YI, YI
읜: IEUNG-YI-NIEUN, YIN
읠: IEUNG-YI-RIEUL, YIL
읨: IEUNG-YI-MIEUM, YIM
읫: IEUNG-YI-SIOS, YIS
이: IEUNG-I, I
익: IEUNG-I-KIYEOK, IG
인: IEUNG-I-NIEUN, IN
일: IEUNG-I-RIEUL, IL
읽: IEUNG-I-RIEULKIYEOK, ILG
읾: IEUNG-I-RIEULMIEUM, ILM
잃: IEUNG-I-RIEULHIEUH, ILH
임: IEUNG-I-MIEUM, IM
입: IEUNG-I-PIEUP, IB
잇: IEUNG-I-SIOS, IS
있: IEUNG-I-SSANGSIOS, ISS
잉: IEUNG-I-IEUNG, ING
잊: IEUNG-I-CIEUC, IJ
잎: IEUNG-I-PHIEUPH, IP
자: CIEUC-A, JA
작: CIEUC-A-KIYEOK, JAG
잔: CIEUC-A-NIEUN, JAN
잖: CIEUC-A-NIEUNHIEUH, JANH
잗: CIEUC-A-TIKEUT, JAD
잘: CIEUC-A-RIEUL, JAL
잚: CIEUC-A-RIEULMIEUM, JALM
잠: CIEUC-A-MIEUM, JAM
잡: CIEUC-A-PIEUP, JAB
잣: CIEUC-A-SIOS, JAS
잤: CIEUC-A-SSANGSIOS, JASS
장: CIEUC-A-IEUNG, JANG
잦: CIEUC-A-CIEUC, JAJ
재: CIEUC-AE, JAE
잭: CIEUC-AE-KIYEOK, JAEG
잰: CIEUC-AE-NIEUN, JAEN
잴: CIEUC-AE-RIEUL, JAEL
잼: CIEUC-AE-MIEUM, JAEM
잽: CIEUC-AE-PIEUP, JAEB
잿: CIEUC-AE-SIOS, JAES
쟀: CIEUC-AE-SSANGSIOS, JAESS
쟁: CIEUC-AE-IEUNG, JAENG
쟈: CIEUC-YA, JYA
쟉: CIEUC-YA-KIYEOK, JYAG
쟌: CIEUC-YA-NIEUN, JYAN
쟎: CIEUC-YA-NIEUNHIEUH, JYANH
쟐: CIEUC-YA-RIEUL, JYAL
쟘: CIEUC-YA-MIEUM, JYAM
쟝: CIEUC-YA-IEUNG, JYANG
쟤: CIEUC-YAE, JYAE
쟨: CIEUC-YAE-NIEUN, JYAEN
쟬: CIEUC-YAE-RIEUL, JYAEL
저: CIEUC-EO, JEO
적: CIEUC-EO-KIYEOK, JEOG
전: CIEUC-EO-NIEUN, JEON
절: CIEUC-EO-RIEUL, JEOL
젊: CIEUC-EO-RIEULMIEUM, JEOLM
점: CIEUC-EO-MIEUM, JEOM
접: CIEUC-EO-PIEUP, JEOB
젓: CIEUC-EO-SIOS, JEOS
정: CIEUC-EO-IEUNG, JEONG
젖: CIEUC-EO-CIEUC, JEOJ
제: CIEUC-E, JE
젝: CIEUC-E-KIYEOK, JEG
젠: CIEUC-E-NIEUN, JEN
젤: CIEUC-E-RIEUL, JEL
젬: CIEUC-E-MIEUM, JEM
젭: CIEUC-E-PIEUP, JEB
젯: CIEUC-E-SIOS, JES
젱: CIEUC-E-IEUNG, JENG
져: CIEUC-YEO, JYEO
젼: CIEUC-YEO-NIEUN, JYEON
졀: CIEUC-YEO-RIEUL, JYEOL
졈: CIEUC-YEO-MIEUM, JYEOM
졉: CIEUC-YEO-PIEUP, JYEOB
졌: CIEUC-YEO-SSANGSIOS, JYEOSS
졍: CIEUC-YEO-IEUNG, JYEONG
졔: CIEUC-YE, JYE
조: CIEUC-O, JO
족: CIEUC-O-KIYEOK, JOG
존: CIEUC-O-NIEUN, JON
졸: CIEUC-O-RIEUL, JOL
졺: CIEUC-O-RIEULMIEUM, JOLM
좀: CIEUC-O-MIEUM, JOM
좁: CIEUC-O-PIEUP, JOB
좃: CIEUC-O-SIOS, JOS
종: CIEUC-O-IEUNG, JONG
좆: CIEUC-O-CIEUC, JOJ
좇: CIEUC-O-CHIEUCH, JOC
좋: CIEUC-O-HIEUH, JOH
좌: CIEUC-WA, JWA
좍: CIEUC-WA-KIYEOK, JWAG
좔: CIEUC-WA-RIEUL, JWAL
좝: CIEUC-WA-PIEUP, JWAB
좟: CIEUC-WA-SIOS, JWAS
좡: CIEUC-WA-IEUNG, JWANG
좨: CIEUC-WAE, JWAE
좼: CIEUC-WAE-SSANGSIOS, JWAESS
좽: CIEUC-WAE-IEUNG, JWAENG
죄: CIEUC-OE, JOE
죈: CIEUC-OE-NIEUN, JOEN
죌: CIEUC-OE-RIEUL, JOEL
죔: CIEUC-OE-MIEUM, JOEM
죕: CIEUC-OE-PIEUP, JOEB
죗: CIEUC-OE-SIOS, JOES
죙: CIEUC-OE-IEUNG, JOENG
죠: CIEUC-YO, JYO
죡: CIEUC-YO-KIYEOK, JYOG
죤: CIEUC-YO-NIEUN, JYON
죵: CIEUC-YO-IEUNG, JYONG
주: CIEUC-U, JU
죽: CIEUC-U-KIYEOK, JUG
준: CIEUC-U-NIEUN, JUN
줄: CIEUC-U-RIEUL, JUL
줅: CIEUC-U-RIEULKIYEOK, JULG
줆: CIEUC-U-RIEULMIEUM, JULM
줌: CIEUC-U-MIEUM, JUM
줍: CIEUC-U-PIEUP, JUB
줏: CIEUC-U-SIOS, JUS
중: CIEUC-U-IEUNG, JUNG
줘: CIEUC-WEO, JWEO
줬: CIEUC-WEO-SSANGSIOS, JWEOSS
줴: CIEUC-WE, JWE
쥐: CIEUC-WI, JWI
쥑: CIEUC-WI-KIYEOK, JWIG
쥔: CIEUC-WI-NIEUN, JWIN
쥘: CIEUC-WI-RIEUL, JWIL
쥠: CIEUC-WI-MIEUM, JWIM
쥡: CIEUC-WI-PIEUP, JWIB
쥣: CIEUC-WI-SIOS, JWIS
쥬: CIEUC-YU, JYU
쥰: CIEUC-YU-NIEUN, JYUN
쥴: CIEUC-YU-RIEUL, JYUL
쥼: CIEUC-YU-MIEUM, JYUM
즈: CIEUC-EU, JEU
즉: CIEUC-EU-KIYEOK, JEUG
즌: CIEUC-EU-NIEUN, JEUN
즐: CIEUC-EU-RIEUL, JEUL
즘: CIEUC-EU-MIEUM, JEUM
즙: CIEUC-EU-PIEUP, JEUB
즛: CIEUC-EU-SIOS, JEUS
증: CIEUC-EU-IEUNG, JEUNG
지: CIEUC-I, JI
직: CIEUC-I-KIYEOK, JIG
진: CIEUC-I-NIEUN, JIN
짇: CIEUC-I-TIKEUT, JID
질: CIEUC-I-RIEUL, JIL
짊: CIEUC-I-RIEULMIEUM, JILM
짐: CIEUC-I-MIEUM, JIM
집: CIEUC-I-PIEUP, JIB
짓: CIEUC-I-SIOS, JIS
징: CIEUC-I-IEUNG, JING
짖: CIEUC-I-CIEUC, JIJ
짙: CIEUC-I-THIEUTH, JIT
짚: CIEUC-I-PHIEUPH, JIP
짜: SSANGCIEUC-A, JJA
짝: SSANGCIEUC-A-KIYEOK, JJAG
짠: SSANGCIEUC-A-NIEUN, JJAN
짢: SSANGCIEUC-A-NIEUNHIEUH, JJANH
짤: SSANGCIEUC-A-RIEUL, JJAL
짧: SSANGCIEUC-A-RIEULPIEUP, JJALB
짬: SSANGCIEUC-A-MIEUM, JJAM
짭: SSANGCIEUC-A-PIEUP, JJAB
짯: SSANGCIEUC-A-SIOS, JJAS
짰: SSANGCIEUC-A-SSANGSIOS, JJASS
짱: SSANGCIEUC-A-IEUNG, JJANG
째: SSANGCIEUC-AE, JJAE
짹: SSANGCIEUC-AE-KIYEOK, JJAEG
짼: SSANGCIEUC-AE-NIEUN, JJAEN
쨀: SSANGCIEUC-AE-RIEUL, JJAEL
쨈: SSANGCIEUC-AE-MIEUM, JJAEM
쨉: SSANGCIEUC-AE-PIEUP, JJAEB
쨋: SSANGCIEUC-AE-SIOS, JJAES
쨌: SSANGCIEUC-AE-SSANGSIOS, JJAESS
쨍: SSANGCIEUC-AE-IEUNG, JJAENG
쨔: SSANGCIEUC-YA, JJYA
쨘: SSANGCIEUC-YA-NIEUN, JJYAN
쨩: SSANGCIEUC-YA-IEUNG, JJYANG
쩌: SSANGCIEUC-EO, JJEO
쩍: SSANGCIEUC-EO-KIYEOK, JJEOG
쩐: SSANGCIEUC-EO-NIEUN, JJEON
쩔: SSANGCIEUC-EO-RIEUL, JJEOL
쩜: SSANGCIEUC-EO-MIEUM, JJEOM
쩝: SSANGCIEUC-EO-PIEUP, JJEOB
쩟: SSANGCIEUC-EO-SIOS, JJEOS
쩠: SSANGCIEUC-EO-SSANGSIOS, JJEOSS
쩡: SSANGCIEUC-EO-IEUNG, JJEONG
쩨: SSANGCIEUC-E, JJE
쩽: SSANGCIEUC-E-IEUNG, JJENG
쪄: SSANGCIEUC-YEO, JJYEO
쪘: SSANGCIEUC-YEO-SSANGSIOS, JJYEOSS
쪼: SSANGCIEUC-O, JJO
쪽: SSANGCIEUC-O-KIYEOK, JJOG
쫀: SSANGCIEUC-O-NIEUN, JJON
쫄: SSANGCIEUC-O-RIEUL, JJOL
쫌: SSANGCIEUC-O-MIEUM, JJOM
쫍: SSANGCIEUC-O-PIEUP, JJOB
쫏: SSANGCIEUC-O-SIOS, JJOS
쫑: SSANGCIEUC-O-IEUNG, JJONG
쫓: SSANGCIEUC-O-CHIEUCH, JJOC
쫘: SSANGCIEUC-WA, JJWA
쫙: SSANGCIEUC-WA-KIYEOK, JJWAG
쫠: SSANGCIEUC-WA-RIEUL, JJWAL
쫬: SSANGCIEUC-WA-SSANGSIOS, JJWASS
쫴: SSANGCIEUC-WAE, JJWAE
쬈: SSANGCIEUC-WAE-SSANGSIOS, JJWAESS
쬐: SSANGCIEUC-OE, JJOE
쬔: SSANGCIEUC-OE-NIEUN, JJOEN
쬘: SSANGCIEUC-OE-RIEUL, JJOEL
쬠: SSANGCIEUC-OE-MIEUM, JJOEM
쬡: SSANGCIEUC-OE-PIEUP, JJOEB
쭁: SSANGCIEUC-YO-IEUNG, JJYONG
쭈: SSANGCIEUC-U, JJU
쭉: SSANGCIEUC-U-KIYEOK, JJUG
쭌: SSANGCIEUC-U-NIEUN, JJUN
쭐: SSANGCIEUC-U-RIEUL, JJUL
쭘: SSANGCIEUC-U-MIEUM, JJUM
쭙: SSANGCIEUC-U-PIEUP, JJUB
쭝: SSANGCIEUC-U-IEUNG, JJUNG
쭤: SSANGCIEUC-WEO, JJWEO
쭸: SSANGCIEUC-WEO-SSANGSIOS, JJWEOSS
쭹: SSANGCIEUC-WEO-IEUNG, JJWEONG
쮜: SSANGCIEUC-WI, JJWI
쮸: SSANGCIEUC-YU, JJYU
쯔: SSANGCIEUC-EU, JJEU
쯤: SSANGCIEUC-EU-MIEUM, JJEUM
쯧: SSANGCIEUC-EU-SIOS, JJEUS
쯩: SSANGCIEUC-EU-IEUNG, JJEUNG
찌: SSANGCIEUC-I, JJI
찍: SSANGCIEUC-I-KIYEOK, JJIG
찐: SSANGCIEUC-I-NIEUN, JJIN
찔: SSANGCIEUC-I-RIEUL, JJIL
찜: SSANGCIEUC-I-MIEUM, JJIM
찝: SSANGCIEUC-I-PIEUP, JJIB
찡: SSANGCIEUC-I-IEUNG, JJING
찢: SSANGCIEUC-I-CIEUC, JJIJ
찧: SSANGCIEUC-I-HIEUH, JJIH
차: CHIEUCH-A, CA
착: CHIEUCH-A-KIYEOK, CAG
찬: CHIEUCH-A-NIEUN, CAN
찮: CHIEUCH-A-NIEUNHIEUH, CANH
찰: CHIEUCH-A-RIEUL, CAL
참: CHIEUCH-A-MIEUM, CAM
찹: CHIEUCH-A-PIEUP, CAB
찻: CHIEUCH-A-SIOS, CAS
찼: CHIEUCH-A-SSANGSIOS, CASS
창: CHIEUCH-A-IEUNG, CANG
찾: CHIEUCH-A-CIEUC, CAJ
채: CHIEUCH-AE, CAE
책: CHIEUCH-AE-KIYEOK, CAEG
챈: CHIEUCH-AE-NIEUN, CAEN
챌: CHIEUCH-AE-RIEUL, CAEL
챔: CHIEUCH-AE-MIEUM, CAEM
챕: CHIEUCH-AE-PIEUP, CAEB
챗: CHIEUCH-AE-SIOS, CAES
챘: CHIEUCH-AE-SSANGSIOS, CAESS
챙: CHIEUCH-AE-IEUNG, CAENG
챠: CHIEUCH-YA, CYA
챤: CHIEUCH-YA-NIEUN, CYAN
챦: CHIEUCH-YA-NIEUNHIEUH, CYANH
챨: CHIEUCH-YA-RIEUL, CYAL
챰: CHIEUCH-YA-MIEUM, CYAM
챵: CHIEUCH-YA-IEUNG, CYANG
처: CHIEUCH-EO, CEO
척: CHIEUCH-EO-KIYEOK, CEOG
천: CHIEUCH-EO-NIEUN, CEON
철: CHIEUCH-EO-RIEUL, CEOL
첨: CHIEUCH-EO-MIEUM, CEOM
첩: CHIEUCH-EO-PIEUP, CEOB
첫: CHIEUCH-EO-SIOS, CEOS
첬: CHIEUCH-EO-SSANGSIOS, CEOSS
청: CHIEUCH-EO-IEUNG, CEONG
체: CHIEUCH-E, CE
첵: CHIEUCH-E-KIYEOK, CEG
첸: CHIEUCH-E-NIEUN, CEN
첼: CHIEUCH-E-RIEUL, CEL
쳄: CHIEUCH-E-MIEUM, CEM
쳅: CHIEUCH-E-PIEUP, CEB
쳇: CHIEUCH-E-SIOS, CES
쳉: CHIEUCH-E-IEUNG, CENG
쳐: CHIEUCH-YEO, CYEO
쳔: CHIEUCH-YEO-NIEUN, CYEON
쳤: CHIEUCH-YEO-SSANGSIOS, CYEOSS
쳬: CHIEUCH-YE, CYE
쳰: CHIEUCH-YE-NIEUN, CYEN
촁: CHIEUCH-YE-IEUNG, CYENG
초: CHIEUCH-O, CO
촉: CHIEUCH-O-KIYEOK, COG
촌: CHIEUCH-O-NIEUN, CON
촐: CHIEUCH-O-RIEUL, COL
촘: CHIEUCH-O-MIEUM, COM
촙: CHIEUCH-O-PIEUP, COB
촛: CHIEUCH-O-SIOS, COS
총: CHIEUCH-O-IEUNG, CONG
촤: CHIEUCH-WA, CWA
촨: CHIEUCH-WA-NIEUN, CWAN
촬: CHIEUCH-WA-RIEUL, CWAL
촹: CHIEUCH-WA-IEUNG, CWANG
최: CHIEUCH-OE, COE
쵠: CHIEUCH-OE-NIEUN, COEN
쵤: CHIEUCH-OE-RIEUL, COEL
쵬: CHIEUCH-OE-MIEUM, COEM
쵭: CHIEUCH-OE-PIEUP, COEB
쵯: CHIEUCH-OE-SIOS, COES
쵱: CHIEUCH-OE-IEUNG, COENG
쵸: CHIEUCH-YO, CYO
춈: CHIEUCH-YO-MIEUM, CYOM
추: CHIEUCH-U, CU
축: CHIEUCH-U-KIYEOK, CUG
춘: CHIEUCH-U-NIEUN, CUN
출: CHIEUCH-U-RIEUL, CUL
춤: CHIEUCH-U-MIEUM, CUM
춥: CHIEUCH-U-PIEUP, CUB
춧: CHIEUCH-U-SIOS, CUS
충: CHIEUCH-U-IEUNG, CUNG
춰: CHIEUCH-WEO, CWEO
췄: CHIEUCH-WEO-SSANGSIOS, CWEOSS
췌: CHIEUCH-WE, CWE
췐: CHIEUCH-WE-NIEUN, CWEN
취: CHIEUCH-WI, CWI
췬: CHIEUCH-WI-NIEUN, CWIN
췰: CHIEUCH-WI-RIEUL, CWIL
췸: CHIEUCH-WI-MIEUM, CWIM
췹: CHIEUCH-WI-PIEUP, CWIB
췻: CHIEUCH-WI-SIOS, CWIS
췽: CHIEUCH-WI-IEUNG, CWING
츄: CHIEUCH-YU, CYU
츈: CHIEUCH-YU-NIEUN, CYUN
츌: CHIEUCH-YU-RIEUL, CYUL
츔: CHIEUCH-YU-MIEUM, CYUM
츙: CHIEUCH-YU-IEUNG, CYUNG
츠: CHIEUCH-EU, CEU
측: CHIEUCH-EU-KIYEOK, CEUG
츤: CHIEUCH-EU-NIEUN, CEUN
츨: CHIEUCH-EU-RIEUL, CEUL
츰: CHIEUCH-EU-MIEUM, CEUM
츱: CHIEUCH-EU-PIEUP, CEUB
츳: CHIEUCH-EU-SIOS, CEUS
층: CHIEUCH-EU-IEUNG, CEUNG
치: CHIEUCH-I, CI
칙: CHIEUCH-I-KIYEOK, CIG
친: CHIEUCH-I-NIEUN, CIN
칟: CHIEUCH-I-TIKEUT, CID
칠: CHIEUCH-I-RIEUL, CIL
칡: CHIEUCH-I-RIEULKIYEOK, CILG
침: CHIEUCH-I-MIEUM, CIM
칩: CHIEUCH-I-PIEUP, CIB
칫: CHIEUCH-I-SIOS, CIS
칭: CHIEUCH-I-IEUNG, CING
카: KHIEUKH-A, KA
칵: KHIEUKH-A-KIYEOK, KAG
칸: KHIEUKH-A-NIEUN, KAN
칼: KHIEUKH-A-RIEUL, KAL
캄: KHIEUKH-A-MIEUM, KAM
캅: KHIEUKH-A-PIEUP, KAB
캇: KHIEUKH-A-SIOS, KAS
캉: KHIEUKH-A-IEUNG, KANG
캐: KHIEUKH-AE, KAE
캑: KHIEUKH-AE-KIYEOK, KAEG
캔: KHIEUKH-AE-NIEUN, KAEN
캘: KHIEUKH-AE-RIEUL, KAEL
캠: KHIEUKH-AE-MIEUM, KAEM
캡: KHIEUKH-AE-PIEUP, KAEB
캣: KHIEUKH-AE-SIOS, KAES
캤: KHIEUKH-AE-SSANGSIOS, KAESS
캥: KHIEUKH-AE-IEUNG, KAENG
캬: KHIEUKH-YA, KYA
캭: KHIEUKH-YA-KIYEOK, KYAG
컁: KHIEUKH-YA-IEUNG, KYANG
커: KHIEUKH-EO, KEO
컥: KHIEUKH-EO-KIYEOK, KEOG
컨: KHIEUKH-EO-NIEUN, KEON
컫: KHIEUKH-EO-TIKEUT, KEOD
컬: KHIEUKH-EO-RIEUL, KEOL
컴: KHIEUKH-EO-MIEUM, KEOM
컵: KHIEUKH-EO-PIEUP, KEOB
컷: KHIEUKH-EO-SIOS, KEOS
컸: KHIEUKH-EO-SSANGSIOS, KEOSS
컹: KHIEUKH-EO-IEUNG, KEONG
케: KHIEUKH-E, KE
켁: KHIEUKH-E-KIYEOK, KEG
켄: KHIEUKH-E-NIEUN, KEN
켈: KHIEUKH-E-RIEUL, KEL
켐: KHIEUKH-E-MIEUM, KEM
켑: KHIEUKH-E-PIEUP, KEB
켓: KHIEUKH-E-SIOS, KES
켕: KHIEUKH-E-IEUNG, KENG
켜: KHIEUKH-YEO, KYEO
켠: KHIEUKH-YEO-NIEUN, KYEON
켤: KHIEUKH-YEO-RIEUL, KYEOL
켬: KHIEUKH-YEO-MIEUM, KYEOM
켭: KHIEUKH-YEO-PIEUP, KYEOB
켯: KHIEUKH-YEO-SIOS, KYEOS
켰: KHIEUKH-YEO-SSANGSIOS, KYEOSS
켱: KHIEUKH-YEO-IEUNG, KYEONG
켸: KHIEUKH-YE, KYE
코: KHIEUKH-O, KO
콕: KHIEUKH-O-KIYEOK, KOG
콘: KHIEUKH-O-NIEUN, KON
콜: KHIEUKH-O-RIEUL, KOL
콤: KHIEUKH-O-MIEUM, KOM
콥: KHIEUKH-O-PIEUP, KOB
콧: KHIEUKH-O-SIOS, KOS
콩: KHIEUKH-O-IEUNG, KONG
콰: KHIEUKH-WA, KWA
콱: KHIEUKH-WA-KIYEOK, KWAG
콴: KHIEUKH-WA-NIEUN, KWAN
콸: KHIEUKH-WA-RIEUL, KWAL
쾀: KHIEUKH-WA-MIEUM, KWAM
쾅: KHIEUKH-WA-IEUNG, KWANG
쾌: KHIEUKH-WAE, KWAE
쾡: KHIEUKH-WAE-IEUNG, KWAENG
쾨: KHIEUKH-OE, KOE
쾰: KHIEUKH-OE-RIEUL, KOEL
쿄: KHIEUKH-YO, KYO
쿠: KHIEUKH-U, KU
쿡: KHIEUKH-U-KIYEOK, KUG
쿤: KHIEUKH-U-NIEUN, KUN
쿨: KHIEUKH-U-RIEUL, KUL
쿰: KHIEUKH-U-MIEUM, KUM
쿱: KHIEUKH-U-PIEUP, KUB
쿳: KHIEUKH-U-SIOS, KUS
쿵: KHIEUKH-U-IEUNG, KUNG
쿼: KHIEUKH-WEO, KWEO
퀀: KHIEUKH-WEO-NIEUN, KWEON
퀄: KHIEUKH-WEO-RIEUL, KWEOL
퀑: KHIEUKH-WEO-IEUNG, KWEONG
퀘: KHIEUKH-WE, KWE
퀭: KHIEUKH-WE-IEUNG, KWENG
퀴: KHIEUKH-WI, KWI
퀵: KHIEUKH-WI-KIYEOK, KWIG
퀸: KHIEUKH-WI-NIEUN, KWIN
퀼: KHIEUKH-WI-RIEUL, KWIL
큄: KHIEUKH-WI-MIEUM, KWIM
큅: KHIEUKH-WI-PIEUP, KWIB
큇: KHIEUKH-WI-SIOS, KWIS
큉: KHIEUKH-WI-IEUNG, KWING
큐: KHIEUKH-YU, KYU
큔: KHIEUKH-YU-NIEUN, KYUN
큘: KHIEUKH-YU-RIEUL, KYUL
큠: KHIEUKH-YU-MIEUM, KYUM
크: KHIEUKH-EU, KEU
큭: KHIEUKH-EU-KIYEOK, KEUG
큰: KHIEUKH-EU-NIEUN, KEUN
클: KHIEUKH-EU-RIEUL, KEUL
큼: KHIEUKH-EU-MIEUM, KEUM
큽: KHIEUKH-EU-PIEUP, KEUB
킁: KHIEUKH-EU-IEUNG, KEUNG
키: KHIEUKH-I, KI
킥: KHIEUKH-I-KIYEOK, KIG
킨: KHIEUKH-I-NIEUN, KIN
킬: KHIEUKH-I-RIEUL, KIL
킴: KHIEUKH-I-MIEUM, KIM
킵: KHIEUKH-I-PIEUP, KIB
킷: KHIEUKH-I-SIOS, KIS
킹: KHIEUKH-I-IEUNG, KING
타: THIEUTH-A, TA
탁: THIEUTH-A-KIYEOK, TAG
탄: THIEUTH-A-NIEUN, TAN
탈: THIEUTH-A-RIEUL, TAL
탉: THIEUTH-A-RIEULKIYEOK, TALG
탐: THIEUTH-A-MIEUM, TAM
탑: THIEUTH-A-PIEUP, TAB
탓: THIEUTH-A-SIOS, TAS
탔: THIEUTH-A-SSANGSIOS, TASS
탕: THIEUTH-A-IEUNG, TANG
태: THIEUTH-AE, TAE
택: THIEUTH-AE-KIYEOK, TAEG
탠: THIEUTH-AE-NIEUN, TAEN
탤: THIEUTH-AE-RIEUL, TAEL
탬: THIEUTH-AE-MIEUM, TAEM
탭: THIEUTH-AE-PIEUP, TAEB
탯: THIEUTH-AE-SIOS, TAES
탰: THIEUTH-AE-SSANGSIOS, TAESS
탱: THIEUTH-AE-IEUNG, TAENG
탸: THIEUTH-YA, TYA
턍: THIEUTH-YA-IEUNG, TYANG
터: THIEUTH-EO, TEO
턱: THIEUTH-EO-KIYEOK, TEOG
턴: THIEUTH-EO-NIEUN, TEON
털: THIEUTH-EO-RIEUL, TEOL
턺: THIEUTH-EO-RIEULMIEUM, TEOLM
텀: THIEUTH-EO-MIEUM, TEOM
텁: THIEUTH-EO-PIEUP, TEOB
텃: THIEUTH-EO-SIOS, TEOS
텄: THIEUTH-EO-SSANGSIOS, TEOSS
텅: THIEUTH-EO-IEUNG, TEONG
테: THIEUTH-E, TE
텍: THIEUTH-E-KIYEOK, TEG
텐: THIEUTH-E-NIEUN, TEN
텔: THIEUTH-E-RIEUL, TEL
템: THIEUTH-E-MIEUM, TEM
텝: THIEUTH-E-PIEUP, TEB
텟: THIEUTH-E-SIOS, TES
텡: THIEUTH-E-IEUNG, TENG
텨: THIEUTH-YEO, TYEO
텬: THIEUTH-YEO-NIEUN, TYEON
텼: THIEUTH-YEO-SSANGSIOS, TYEOSS
톄: THIEUTH-YE, TYE
톈: THIEUTH-YE-NIEUN, TYEN
토: THIEUTH-O, TO
톡: THIEUTH-O-KIYEOK, TOG
톤: THIEUTH-O-NIEUN, TON
톨: THIEUTH-O-RIEUL, TOL
톰: THIEUTH-O-MIEUM, TOM
톱: THIEUTH-O-PIEUP, TOB
톳: THIEUTH-O-SIOS, TOS
통: THIEUTH-O-IEUNG, TONG
톺: THIEUTH-O-PHIEUPH, TOP
톼: THIEUTH-WA, TWA
퇀: THIEUTH-WA-NIEUN, TWAN
퇘: THIEUTH-WAE, TWAE
퇴: THIEUTH-OE, TOE
퇸: THIEUTH-OE-NIEUN, TOEN
툇: THIEUTH-OE-SIOS, TOES
툉: THIEUTH-OE-IEUNG, TOENG
툐: THIEUTH-YO, TYO
투: THIEUTH-U, TU
툭: THIEUTH-U-KIYEOK, TUG
툰: THIEUTH-U-NIEUN, TUN
툴: THIEUTH-U-RIEUL, TUL
툼: THIEUTH-U-MIEUM, TUM
툽: THIEUTH-U-PIEUP, TUB
툿: THIEUTH-U-SIOS, TUS
퉁: THIEUTH-U-IEUNG, TUNG
퉈: THIEUTH-WEO, TWEO
퉜: THIEUTH-WEO-SSANGSIOS, TWEOSS
퉤: THIEUTH-WE, TWE
튀: THIEUTH-WI, TWI
튁: THIEUTH-WI-KIYEOK, TWIG
튄: THIEUTH-WI-NIEUN, TWIN
튈: THIEUTH-WI-RIEUL, TWIL
튐: THIEUTH-WI-MIEUM, TWIM
튑: THIEUTH-WI-PIEUP, TWIB
튕: THIEUTH-WI-IEUNG, TWING
튜: THIEUTH-YU, TYU
튠: THIEUTH-YU-NIEUN, TYUN
튤: THIEUTH-YU-RIEUL, TYUL
튬: THIEUTH-YU-MIEUM, TYUM
튱: THIEUTH-YU-IEUNG, TYUNG
트: THIEUTH-EU, TEU
특: THIEUTH-EU-KIYEOK, TEUG
튼: THIEUTH-EU-NIEUN, TEUN
튿: THIEUTH-EU-TIKEUT, TEUD
틀: THIEUTH-EU-RIEUL, TEUL
틂: THIEUTH-EU-RIEULMIEUM, TEULM
틈: THIEUTH-EU-MIEUM, TEUM
틉: THIEUTH-EU-PIEUP, TEUB
틋: THIEUTH-EU-SIOS, TEUS
틔: THIEUTH-YI, TYI
틘: THIEUTH-YI-NIEUN, TYIN
틜: THIEUTH-YI-RIEUL, TYIL
틤: THIEUTH-YI-MIEUM, TYIM
틥: THIEUTH-YI-PIEUP, TYIB
티: THIEUTH-I, TI
틱: THIEUTH-I-KIYEOK, TIG
틴: THIEUTH-I-NIEUN, TIN
틸: THIEUTH-I-RIEUL, TIL
팀: THIEUTH-I-MIEUM, TIM
팁: THIEUTH-I-PIEUP, TIB
팃: THIEUTH-I-SIOS, TIS
팅: THIEUTH-I-IEUNG, TING
파: PHIEUPH-A, PA
팍: PHIEUPH-A-KIYEOK, PAG
팎: PHIEUPH-A-SSANGKIYEOK, PAGG
판: PHIEUPH-A-NIEUN, PAN
팔: PHIEUPH-A-RIEUL, PAL
팖: PHIEUPH-A-RIEULMIEUM, PALM
팜: PHIEUPH-A-MIEUM, PAM
팝: PHIEUPH-A-PIEUP, PAB
팟: PHIEUPH-A-SIOS, PAS
팠: PHIEUPH-A-SSANGSIOS, PASS
팡: PHIEUPH-A-IEUNG, PANG
팥: PHIEUPH-A-THIEUTH, PAT
패: PHIEUPH-AE, PAE
팩: PHIEUPH-AE-KIYEOK, PAEG
팬: PHIEUPH-AE-NIEUN, PAEN
팰: PHIEUPH-AE-RIEUL, PAEL
팸: PHIEUPH-AE-MIEUM, PAEM
팹: PHIEUPH-AE-PIEUP, PAEB
팻: PHIEUPH-AE-SIOS, PAES
팼: PHIEUPH-AE-SSANGSIOS, PAESS
팽: PHIEUPH-AE-IEUNG, PAENG
퍄: PHIEUPH-YA, PYA
퍅: PHIEUPH-YA-KIYEOK, PYAG
퍼: PHIEUPH-EO, PEO
퍽: PHIEUPH-EO-KIYEOK, PEOG
펀: PHIEUPH-EO-NIEUN, PEON
펄: PHIEUPH-EO-RIEUL, PEOL
펌: PHIEUPH-EO-MIEUM, PEOM
펍: PHIEUPH-EO-PIEUP, PEOB
펏: PHIEUPH-EO-SIOS, PEOS
펐: PHIEUPH-EO-SSANGSIOS, PEOSS
펑: PHIEUPH-EO-IEUNG, PEONG
페: PHIEUPH-E, PE
펙: PHIEUPH-E-KIYEOK, PEG
펜: PHIEUPH-E-NIEUN, PEN
펠: PHIEUPH-E-RIEUL, PEL
펨: PHIEUPH-E-MIEUM, PEM
펩: PHIEUPH-E-PIEUP, PEB
펫: PHIEUPH-E-SIOS, PES
펭: PHIEUPH-E-IEUNG, PENG
펴: PHIEUPH-YEO, PYEO
편: PHIEUPH-YEO-NIEUN, PYEON
펼: PHIEUPH-YEO-RIEUL, PYEOL
폄: PHIEUPH-YEO-MIEUM, PYEOM
폅: PHIEUPH-YEO-PIEUP, PYEOB
폈: PHIEUPH-YEO-SSANGSIOS, PYEOSS
평: PHIEUPH-YEO-IEUNG, PYEONG
폐: PHIEUPH-YE, PYE
폘: PHIEUPH-YE-RIEUL, PYEL
폡: PHIEUPH-YE-PIEUP, PYEB
폣: PHIEUPH-YE-SIOS, PYES
포: PHIEUPH-O, PO
폭: PHIEUPH-O-KIYEOK, POG
폰: PHIEUPH-O-NIEUN, PON
폴: PHIEUPH-O-RIEUL, POL
폼: PHIEUPH-O-MIEUM, POM
폽: PHIEUPH-O-PIEUP, POB
폿: PHIEUPH-O-SIOS, POS
퐁: PHIEUPH-O-IEUNG, PONG
퐈: PHIEUPH-WA, PWA
퐝: PHIEUPH-WA-IEUNG, PWANG
푀: PHIEUPH-OE, POE
푄: PHIEUPH-OE-NIEUN, POEN
표: PHIEUPH-YO, PYO
푠: PHIEUPH-YO-NIEUN, PYON
푤: PHIEUPH-YO-RIEUL, PYOL
푭: PHIEUPH-YO-PIEUP, PYOB
푯: PHIEUPH-YO-SIOS, PYOS
푸: PHIEUPH-U, PU
푹: PHIEUPH-U-KIYEOK, PUG
푼: PHIEUPH-U-NIEUN, PUN
푿: PHIEUPH-U-TIKEUT, PUD
풀: PHIEUPH-U-RIEUL, PUL
풂: PHIEUPH-U-RIEULMIEUM, PULM
품: PHIEUPH-U-MIEUM, PUM
풉: PHIEUPH-U-PIEUP, PUB
풋: PHIEUPH-U-SIOS, PUS
풍: PHIEUPH-U-IEUNG, PUNG
풔: PHIEUPH-WEO, PWEO
풩: PHIEUPH-WEO-IEUNG, PWEONG
퓌: PHIEUPH-WI, PWI
퓐: PHIEUPH-WI-NIEUN, PWIN
퓔: PHIEUPH-WI-RIEUL, PWIL
퓜: PHIEUPH-WI-MIEUM, PWIM
퓟: PHIEUPH-WI-SIOS, PWIS
퓨: PHIEUPH-YU, PYU
퓬: PHIEUPH-YU-NIEUN, PYUN
퓰: PHIEUPH-YU-RIEUL, PYUL
퓸: PHIEUPH-YU-MIEUM, PYUM
퓻: PHIEUPH-YU-SIOS, PYUS
퓽: PHIEUPH-YU-IEUNG, PYUNG
프: PHIEUPH-EU, PEU
픈: PHIEUPH-EU-NIEUN, PEUN
플: PHIEUPH-EU-RIEUL, PEUL
픔: PHIEUPH-EU-MIEUM, PEUM
픕: PHIEUPH-EU-PIEUP, PEUB
픗: PHIEUPH-EU-SIOS, PEUS
피: PHIEUPH-I, PI
픽: PHIEUPH-I-KIYEOK, PIG
핀: PHIEUPH-I-NIEUN, PIN
필: PHIEUPH-I-RIEUL, PIL
핌: PHIEUPH-I-MIEUM, PIM
핍: PHIEUPH-I-PIEUP, PIB
핏: PHIEUPH-I-SIOS, PIS
핑: PHIEUPH-I-IEUNG, PING
하: HIEUH-A, HA
학: HIEUH-A-KIYEOK, HAG
한: HIEUH-A-NIEUN, HAN
할: HIEUH-A-RIEUL, HAL
핥: HIEUH-A-RIEULTHIEUTH, HALT
함: HIEUH-A-MIEUM, HAM
합: HIEUH-A-PIEUP, HAB
핫: HIEUH-A-SIOS, HAS
항: HIEUH-A-IEUNG, HANG
해: HIEUH-AE, HAE
핵: HIEUH-AE-KIYEOK, HAEG
핸: HIEUH-AE-NIEUN, HAEN
핼: HIEUH-AE-RIEUL, HAEL
햄: HIEUH-AE-MIEUM, HAEM
햅: HIEUH-AE-PIEUP, HAEB
햇: HIEUH-AE-SIOS, HAES
했: HIEUH-AE-SSANGSIOS, HAESS
행: HIEUH-AE-IEUNG, HAENG
햐: HIEUH-YA, HYA
향: HIEUH-YA-IEUNG, HYANG
허: HIEUH-EO, HEO
헉: HIEUH-EO-KIYEOK, HEOG
헌: HIEUH-EO-NIEUN, HEON
헐: HIEUH-EO-RIEUL, HEOL
헒: HIEUH-EO-RIEULMIEUM, HEOLM
험: HIEUH-EO-MIEUM, HEOM
헙: HIEUH-EO-PIEUP, HEOB
헛: HIEUH-EO-SIOS, HEOS
헝: HIEUH-EO-IEUNG, HEONG
헤: HIEUH-E, HE
헥: HIEUH-E-KIYEOK, HEG
헨: HIEUH-E-NIEUN, HEN
헬: HIEUH-E-RIEUL, HEL
헴: HIEUH-E-MIEUM, HEM
헵: HIEUH-E-PIEUP, HEB
헷: HIEUH-E-SIOS, HES
헹: HIEUH-E-IEUNG, HENG
혀: HIEUH-YEO, HYEO
혁: HIEUH-YEO-KIYEOK, HYEOG
현: HIEUH-YEO-NIEUN, HYEON
혈: HIEUH-YEO-RIEUL, HYEOL
혐: HIEUH-YEO-MIEUM, HYEOM
협: HIEUH-YEO-PIEUP, HYEOB
혓: HIEUH-YEO-SIOS, HYEOS
혔: HIEUH-YEO-SSANGSIOS, HYEOSS
형: HIEUH-YEO-IEUNG, HYEONG
혜: HIEUH-YE, HYE
혠: HIEUH-YE-NIEUN, HYEN
혤: HIEUH-YE-RIEUL, HYEL
혭: HIEUH-YE-PIEUP, HYEB
호: HIEUH-O, HO
혹: HIEUH-O-KIYEOK, HOG
혼: HIEUH-O-NIEUN, HON
홀: HIEUH-O-RIEUL, HOL
홅: HIEUH-O-RIEULTHIEUTH, HOLT
홈: HIEUH-O-MIEUM, HOM
홉: HIEUH-O-PIEUP, HOB
홋: HIEUH-O-SIOS, HOS
홍: HIEUH-O-IEUNG, HONG
홑: HIEUH-O-THIEUTH, HOT
화: HIEUH-WA, HWA
확: HIEUH-WA-KIYEOK, HWAG
환: HIEUH-WA-NIEUN, HWAN
활: HIEUH-WA-RIEUL, HWAL
홧: HIEUH-WA-SIOS, HWAS
황: HIEUH-WA-IEUNG, HWANG
홰: HIEUH-WAE, HWAE
홱: HIEUH-WAE-KIYEOK, HWAEG
홴: HIEUH-WAE-NIEUN, HWAEN
횃: HIEUH-WAE-SIOS, HWAES
횅: HIEUH-WAE-IEUNG, HWAENG
회: HIEUH-OE, HOE
획: HIEUH-OE-KIYEOK, HOEG
횐: HIEUH-OE-NIEUN, HOEN
횔: HIEUH-OE-RIEUL, HOEL
횝: HIEUH-OE-PIEUP, HOEB
횟: HIEUH-OE-SIOS, HOES
횡: HIEUH-OE-IEUNG, HOENG
효: HIEUH-YO, HYO
횬: HIEUH-YO-NIEUN, HYON
횰: HIEUH-YO-RIEUL, HYOL
횹: HIEUH-YO-PIEUP, HYOB
횻: HIEUH-YO-SIOS, HYOS
후: HIEUH-U, HU
훅: HIEUH-U-KIYEOK, HUG
훈: HIEUH-U-NIEUN, HUN
훌: HIEUH-U-RIEUL, HUL
훑: HIEUH-U-RIEULTHIEUTH, HULT
훔: HIEUH-U-MIEUM, HUM
훗: HIEUH-U-SIOS, HUS
훙: HIEUH-U-IEUNG, HUNG
훠: HIEUH-WEO, HWEO
훤: HIEUH-WEO-NIEUN, HWEON
훨: HIEUH-WEO-RIEUL, HWEOL
훰: HIEUH-WEO-MIEUM, HWEOM
훵: HIEUH-WEO-IEUNG, HWEONG
훼: HIEUH-WE, HWE
훽: HIEUH-WE-KIYEOK, HWEG
휀: HIEUH-WE-NIEUN, HWEN
휄: HIEUH-WE-RIEUL, HWEL
휑: HIEUH-WE-IEUNG, HWENG
휘: HIEUH-WI, HWI
휙: HIEUH-WI-KIYEOK, HWIG
휜: HIEUH-WI-NIEUN, HWIN
휠: HIEUH-WI-RIEUL, HWIL
휨: HIEUH-WI-MIEUM, HWIM
휩: HIEUH-WI-PIEUP, HWIB
휫: HIEUH-WI-SIOS, HWIS
휭: HIEUH-WI-IEUNG, HWING
휴: HIEUH-YU, HYU
휵: HIEUH-YU-KIYEOK, HYUG
휸: HIEUH-YU-NIEUN, HYUN
휼: HIEUH-YU-RIEUL, HYUL
흄: HIEUH-YU-MIEUM, HYUM
흇: HIEUH-YU-SIOS, HYUS
흉: HIEUH-YU-IEUNG, HYUNG
흐: HIEUH-EU, HEU
흑: HIEUH-EU-KIYEOK, HEUG
흔: HIEUH-EU-NIEUN, HEUN
흖: HIEUH-EU-NIEUNHIEUH, HEUNH
흗: HIEUH-EU-TIKEUT, HEUD
흘: HIEUH-EU-RIEUL, HEUL
흙: HIEUH-EU-RIEULKIYEOK, HEULG
흠: HIEUH-EU-MIEUM, HEUM
흡: HIEUH-EU-PIEUP, HEUB
흣: HIEUH-EU-SIOS, HEUS
흥: HIEUH-EU-IEUNG, HEUNG
흩: HIEUH-EU-THIEUTH, HEUT
희: HIEUH-YI, HYI
흰: HIEUH-YI-NIEUN, HYIN
흴: HIEUH-YI-RIEUL, HYIL
흼: HIEUH-YI-MIEUM, HYIM
흽: HIEUH-YI-PIEUP, HYIB
힁: HIEUH-YI-IEUNG, HYING
히: HIEUH-I, HI
힉: HIEUH-I-KIYEOK, HIG
힌: HIEUH-I-NIEUN, HIN
힐: HIEUH-I-RIEUL, HIL
힘: HIEUH-I-MIEUM, HIM
힙: HIEUH-I-PIEUP, HIB
힛: HIEUH-I-SIOS, HIS
힝: HIEUH-I-IEUNG, HING
