가: KIYEOK-A
각: KIYEOK-A-KIYEOK
간: KIYEOK-A-NIEUN
갇: KIYEOK-A-TIKEUT
갈: KIYEOK-A-RIEUL
갉: KIYEOK-A-RIEULKIYEOK
갊: KIYEOK-A-RIEULMIEUM
감: KIYEOK-A-MIEUM
갑: KIYEOK-A-PIEUP
값: KIYEOK-A-PIEUPSIOS
갓: KIYEOK-A-SIOS
갔: KIYEOK-A-SSANGSIOS
강: KIYEOK-A-IEUNG
갖: KIYEOK-A-CIEUC
갗: KIYEOK-A-CHIEUCH
같: KIYEOK-A-THIEUTH
갚: KIYEOK-A-PHIEUPH
갛: KIYEOK-A-HIEUH
개: KIYEOK-AE
객: KIYEOK-AE-KIYEOK
갠: KIYEOK-AE-NIEUN
갤: KIYEOK-AE-RIEUL
갬: KIYEOK-AE-MIEUM
갭: KIYEOK-AE-PIEUP
갯: KIYEOK-AE-SIOS
갰: KIYEOK-AE-SSANGSIOS
갱: KIYEOK-AE-IEUNG
갸: KIYEOK-YA
갹: KIYEOK-YA-KIYEOK
갼: KIYEOK-YA-NIEUN
걀: KIYEOK-YA-RIEUL
걋: CHIEUCH-O-KIYEOKSIOS
걍: CHIEUCH-O-NIEUNHIEUH
걔: CHIEUCH-O-RIEULPHIEUPH
걘: CHIEUCH-O-CIEUC
걜: KIYEOK-YAE-RIEUL
거: CHIEUCH-WA-RIEULHIEUH
걱: CHIEUCH-WA-MIEUM
건: CHIEUCH-WA-SIOS
걷: CHIEUCH-WA-CHIEUCH
걸: CHIEUCH-WA-KHIEUKH
걺: CHIEUCH-WA-PHIEUPH
검: KIYEOK-EO-MIEUM
겁: CHIEUCH-WA-HIEUH
것: CHIEUCH-WAE-KIYEOK
겄: CHIEUCH-WAE-SSANGKIYEOK
겅: CHIEUCH-WAE-KIYEOKSIOS
겆: CHIEUCH-WAE-NIEUN
겉: CHIEUCH-WAE-TIKEUT
겊: CHIEUCH-WAE-RIEUL
겋: CHIEUCH-WAE-RIEULKIYEOK
게: CHIEUCH-WAE-RIEULMIEUM
겐: CHIEUCH-WAE-RIEULPHIEUPH
겔: CHIEUCH-WAE-PIEUPSIOS
겜: CHIEUCH-WAE-PHIEUPH
겝: CHIEUCH-WAE-HIEUH
겟: CHIEUCH-OE-SSANGKIYEOK
겠: CHIEUCH-OE-KIYEOKSIOS
겡: KIYEOK-E-IEUNG
겨: KIYEOK-YEO
격: KIYEOK-YEO-KIYEOK
겪: KIYEOK-YEO-SSANGKIYEOK
견: KIYEOK-YEO-NIEUN
겯: KIYEOK-YEO-TIKEUT
결: KIYEOK-YEO-RIEUL
겸: KIYEOK-YEO-MIEUM
겹: KIYEOK-YEO-PIEUP
겻: KIYEOK-YEO-SIOS
겼: KIYEOK-YEO-SSANGSIOS
경: KIYEOK-YEO-IEUNG
곁: KIYEOK-YEO-THIEUTH
계: KIYEOK-YE
곈: KIYEOK-YE-NIEUN
곌: KIYEOK-YE-RIEUL
곕: KIYEOK-YE-PIEUP
곗: KIYEOK-YE-SIOS
고: KIYEOK-O
곡: KIYEOK-O-KIYEOK
곤: KIYEOK-O-NIEUN
곧: KIYEOK-O-TIKEUT
골: KIYEOK-O-RIEUL
곪: KIYEOK-O-RIEULMIEUM
곬: KIYEOK-O-RIEULSIOS
곯: KIYEOK-O-RIEULHIEUH
곰: KIYEOK-O-MIEUM
곱: KIYEOK-O-PIEUP
곳: KIYEOK-O-SIOS
공: KIYEOK-O-IEUNG
곶: KIYEOK-O-CIEUC
과: KIYEOK-WA
곽: KIYEOK-WA-KIYEOK
관: KIYEOK-WA-NIEUN
괄: KIYEOK-WA-RIEUL
괆: KIYEOK-WA-RIEULMIEUM
괌: KIYEOK-WA-MIEUM
괍: KIYEOK-WA-PIEUP
괏: KIYEOK-WA-SIOS
광: KIYEOK-WA-IEUNG
괘: KIYEOK-WAE
괜: KIYEOK-WAE-NIEUN
괠: KIYEOK-WAE-RIEUL
괩: KIYEOK-WAE-PIEUP
괬: KIYEOK-WAE-SSANGSIOS
괭: KIYEOK-WAE-IEUNG
괴: KIYEOK-OE
괵: KIYEOK-OE-KIYEOK
괸: KIYEOK-OE-NIEUN
괼: KIYEOK-OE-RIEUL
굄: CHIEUCH-OE-RIEULKIYEOK
굅: CHIEUCH-OE-RIEULMIEUM
굇: CHIEUCH-OE-RIEULSIOS
굉: CHIEUCH-OE-RIEULPHIEUPH
교: CHIEUCH-OE-THIEUTH
굔: CHIEUCH-YO-SSANGKIYEOK
굘: CHIEUCH-YO-NIEUNHIEUH
굡: CHIEUCH-YO-RIEULKIYEOK
굣: CHIEUCH-YO-RIEULPIEUP
구: CHIEUCH-YO-IEUNG
국: CHIEUCH-YO-CIEUC
군: CHIEUCH-YO-THIEUTH
굳: CHIEUCH-U-SSANGKIYEOK
굴: CHIEUCH-U-KIYEOKSIOS
굵: CHIEUCH-U-NIEUNCIEUC
굶: CHIEUCH-U-NIEUNHIEUH
굻: KIYEOK-U-RIEULHIEUH
굼: KIYEOK-U-MIEUM
굽: KIYEOK-U-PIEUP
굿: KIYEOK-U-SIOS
궁: CHIEUCH-U-RIEULSIOS
궂: CHIEUCH-U-RIEULTHIEUTH
궈: CHIEUCH-U-CHIEUCH
궉: CHIEUCH-U-KHIEUKH
권: CHIEUCH-U-HIEUH
궐: CHIEUCH-WEO-NIEUN
궜: CHIEUCH-WEO-MIEUM
궝: CHIEUCH-WEO-PIEUP
궤: KIYEOK-WE
궷: KIYEOK-WE-SIOS
귀: KIYEOK-WI
귁: KIYEOK-WI-KIYEOK
귄: KIYEOK-WI-NIEUN
귈: KIYEOK-WI-RIEUL
귐: KIYEOK-WI-MIEUM
귑: KIYEOK-WI-PIEUP
귓: KIYEOK-WI-SIOS
규: KIYEOK-YU
균: KIYEOK-YU-NIEUN
귤: KIYEOK-YU-RIEUL
그: KIYEOK-EU
극: KIYEOK-EU-KIYEOK
근: KIYEOK-EU-NIEUN
귿: KIYEOK-EU-TIKEUT
글: KIYEOK-EU-RIEUL
긁: KIYEOK-EU-RIEULKIYEOK
금: KIYEOK-EU-MIEUM
급: KIYEOK-EU-PIEUP
긋: KIYEOK-EU-SIOS
긍: KIYEOK-EU-IEUNG
긔: KIYEOK-YI
기: KIYEOK-I
긱: KIYEOK-I-KIYEOK
긴: KIYEOK-I-NIEUN
긷: KIYEOK-I-TIKEUT
길: KIYEOK-I-RIEUL
긺: KIYEOK-I-RIEULMIEUM
김: KIYEOK-I-MIEUM
깁: CHIEUCH-WEO-CIEUC
깃: CHIEUCH-WEO-KHIEUKH
깅: CHIEUCH-WEO-PHIEUPH
깆: CHIEUCH-WEO-HIEUH
깊: CHIEUCH-WE-NIEUNCIEUC
까: CHIEUCH-WE-TIKEUT
깍: CHIEUCH-WE-RIEUL
깎: CHIEUCH-WE-RIEULKIYEOK
깐: CHIEUCH-WE-RIEULPIEUP
깔: CHIEUCH-WE-RIEULHIEUH
깖: CHIEUCH-WE-PIEUP
깜: SSANGKIYEOK-A-MIEUM
깝: SSANGKIYEOK-A-PIEUP
깟: SSANGKIYEOK-A-SIOS
깠: SSANGKIYEOK-A-SSANGSIOS
깡: CHIEUCH-WE-CIEUC
깥: CHIEUCH-WE-PHIEUPH
깨: CHIEUCH-WI-SSANGKIYEOK
깩: CHIEUCH-WI-KIYEOKSIOS
깬: CHIEUCH-WI-TIKEUT
깰: CHIEUCH-WI-RIEULSIOS
깸: CHIEUCH-WI-KHIEUKH
깹: CHIEUCH-WI-THIEUTH
깻: SSANGKIYEOK-AE-SIOS
깼: SSANGKIYEOK-AE-SSANGSIOS
깽: SSANGKIYEOK-AE-IEUNG
꺄: CHIEUCH-YU-KIYEOKSIOS
꺅: CHIEUCH-YU-NIEUNCIEUC
꺌: CHIEUCH-YU-RIEULTHIEUTH
꺼: SSANGKIYEOK-EO
꺽: SSANGKIYEOK-EO-KIYEOK
꺾: SSANGKIYEOK-EO-SSANGKIYEOK
껀: SSANGKIYEOK-EO-NIEUN
껄: SSANGKIYEOK-EO-RIEUL
껌: SSANGKIYEOK-EO-MIEUM
껍: SSANGKIYEOK-EO-PIEUP
껏: SSANGKIYEOK-EO-SIOS
껐: SSANGKIYEOK-EO-SSANGSIOS
껑: SSANGKIYEOK-EO-IEUNG
께: SSANGKIYEOK-E
껙: SSANGKIYEOK-E-KIYEOK
껜: SSANGKIYEOK-E-NIEUN
껨: SSANGKIYEOK-E-MIEUM
껫: SSANGKIYEOK-E-SIOS
껭: SSANGKIYEOK-E-IEUNG
껴: SSANGKIYEOK-YEO
껸: SSANGKIYEOK-YEO-NIEUN
껼: SSANGKIYEOK-YEO-RIEUL
꼇: SSANGKIYEOK-YEO-SIOS
꼈: SSANGKIYEOK-YEO-SSANGSIOS
꼍: SSANGKIYEOK-YEO-THIEUTH
꼐: SSANGKIYEOK-YE
꼬: SSANGKIYEOK-O
꼭: SSANGKIYEOK-O-KIYEOK
꼰: SSANGKIYEOK-O-NIEUN
꼲: SSANGKIYEOK-O-NIEUNHIEUH
꼴: SSANGKIYEOK-O-RIEUL
꼼: SSANGKIYEOK-O-MIEUM
꼽: SSANGKIYEOK-O-PIEUP
꼿: SSANGKIYEOK-O-SIOS
꽁: CHIEUCH-EU-RIEULSIOS
꽂: CHIEUCH-EU-RIEULTHIEUTH
꽃: CHIEUCH-EU-RIEULPHIEUPH
꽈: CHIEUCH-EU-CHIEUCH
꽉: CHIEUCH-EU-KHIEUKH
꽐: CHIEUCH-YI-KIYEOKSIOS
꽜: SSANGKIYEOK-WA-SSANGSIOS
꽝: SSANGKIYEOK-WA-IEUNG
꽤: CHIEUCH-YI-PIEUP
꽥: CHIEUCH-YI-PIEUPSIOS
꽹: CHIEUCH-I-PIEUPSIOS
꾀: SSANGKIYEOK-OE
꾄: CHIEUCH-I-THIEUTH
꾈: KHIEUKH-A-KIYEOKSIOS
꾐: KHIEUKH-A-RIEULTHIEUTH
꾑: KHIEUKH-A-RIEULPHIEUPH
꾕: KHIEUKH-A-CIEUC
꾜: KHIEUKH-AE-KIYEOKSIOS
꾸: SSANGKIYEOK-U
꾹: SSANGKIYEOK-U-KIYEOK
꾼: SSANGKIYEOK-U-NIEUN
꿀: SSANGKIYEOK-U-RIEUL
꿇: SSANGKIYEOK-U-RIEULHIEUH
꿈: SSANGKIYEOK-U-MIEUM
꿉: SSANGKIYEOK-U-PIEUP
꿋: SSANGKIYEOK-U-SIOS
꿍: SSANGKIYEOK-U-IEUNG
꿎: SSANGKIYEOK-U-CIEUC
꿔: SSANGKIYEOK-WEO
꿜: SSANGKIYEOK-WEO-RIEUL
꿨: SSANGKIYEOK-WEO-SSANGSIOS
꿩: SSANGKIYEOK-WEO-IEUNG
꿰: SSANGKIYEOK-WE
꿱: SSANGKIYEOK-WE-KIYEOK
꿴: SSANGKIYEOK-WE-NIEUN
꿸: SSANGKIYEOK-WE-RIEUL
뀀: SSANGKIYEOK-WE-MIEUM
뀁: SSANGKIYEOK-WE-PIEUP
뀄: SSANGKIYEOK-WE-SSANGSIOS
뀌: SSANGKIYEOK-WI
뀐: SSANGKIYEOK-WI-NIEUN
뀔: SSANGKIYEOK-WI-RIEUL
뀜: SSANGKIYEOK-WI-MIEUM
뀝: SSANGKIYEOK-WI-PIEUP
뀨: SSANGKIYEOK-YU
끄: KHIEUKH-AE-RIEULTHIEUTH
끅: KHIEUKH-AE-RIEULPHIEUPH
끈: KHIEUKH-AE-CIEUC
끊: KHIEUKH-AE-KHIEUKH
끌: KHIEUKH-AE-PHIEUPH
끎: KHIEUKH-YA-SSANGKIYEOK
끓: KHIEUKH-YA-TIKEUT
끔: KHIEUKH-YA-RIEUL
끕: KHIEUKH-YA-RIEULKIYEOK
끗: KHIEUKH-YA-RIEULPIEUP
끙: KHIEUKH-YA-RIEULTHIEUTH
끝: SSANGKIYEOK-EU-THIEUTH
끼: SSANGKIYEOK-I
끽: SSANGKIYEOK-I-KIYEOK
낀: SSANGKIYEOK-I-NIEUN
낄: KHIEUKH-YAE-PIEUP
낌: KHIEUKH-YAE-THIEUTH
낍: KHIEUKH-YAE-PHIEUPH
낏: KHIEUKH-EO-SSANGKIYEOK
낑: KHIEUKH-EO-NIEUNCIEUC
나: KHIEUKH-EO-RIEULPHIEUPH
낙: KHIEUKH-EO-RIEULHIEUH
낚: KHIEUKH-EO-PIEUPSIOS
난: KHIEUKH-EO-CHIEUCH
낟: KHIEUKH-EO-PHIEUPH
날: KHIEUKH-EO-HIEUH
낡: KIYEOK-A
낢: KIYEOK-A-KIYEOK
남: KIYEOK-A-MIEUM
납: KIYEOK-A-PIEUP
낫: KIYEOK-A-SIOS
났: KIYEOK-A-SSANGSIOS
낭: KIYEOK-A-IEUNG
낮: KIYEOK-A-CIEUC
낯: KIYEOK-A-CHIEUCH
낱: KIYEOK-A-PHIEUPH
낳: KIYEOK-AE
내: KIYEOK-AE-KIYEOK
낵: KIYEOK-AE-NIEUN
낸: KIYEOK-AE-PIEUP
낼: KIYEOK-YA
냄: KIYEOK-YAE-RIEUL
냅: KIYEOK-EO
냇: KIYEOK-EO-NIEUN
냈: KIYEOK-EO-TIKEUT
냉: KIYEOK-EO-RIEUL
냐: KIYEOK-EO-CIEUC
냑: KIYEOK-EO-THIEUTH
냔: KIYEOK-E
냘: KIYEOK-E-PIEUP
냠: KIYEOK-YEO-TIKEUT
냥: KIYEOK-YEO-SSANGSIOS
너: NIEUN-EO
넉: NIEUN-EO-KIYEOK
넋: NIEUN-EO-KIYEOKSIOS
넌: NIEUN-EO-NIEUN
널: NIEUN-EO-RIEUL
넒: NIEUN-EO-RIEULMIEUM
넓: NIEUN-EO-RIEULPIEUP
넘: NIEUN-EO-MIEUM
넙: NIEUN-EO-PIEUP
넛: NIEUN-EO-SIOS
넜: NIEUN-EO-SSANGSIOS
넝: NIEUN-EO-IEUNG
넣: NIEUN-EO-HIEUH
네: NIEUN-E
넥: NIEUN-E-KIYEOK
넨: NIEUN-E-NIEUN
넬: NIEUN-E-RIEUL
넴: NIEUN-E-MIEUM
넵: NIEUN-E-PIEUP
넷: NIEUN-E-SIOS
넸: NIEUN-E-SSANGSIOS
넹: NIEUN-E-IEUNG
녀: NIEUN-YEO
녁: KHIEUKH-E-SSANGKIYEOK
년: KHIEUKH-E-NIEUNHIEUH
녈: KHIEUKH-E-RIEULPIEUP
념: KHIEUKH-E-CHIEUCH
녑: KHIEUKH-E-KHIEUKH
녔: KHIEUKH-E-HIEUH
녕: KHIEUKH-YEO-KIYEOK
녘: KHIEUKH-YEO-NIEUNCIEUC
녜: NIEUN-YE
녠: NIEUN-YE-NIEUN
노: KHIEUKH-YE-RIEULMIEUM
녹: KHIEUKH-YE-RIEULPIEUP
논: NIEUN-O-NIEUN
놀: NIEUN-O-RIEUL
놂: KHIEUKH-YE-RIEULPHIEUPH
놈: KHIEUKH-YE-SSANGSIOS
놉: KHIEUKH-YE-IEUNG
놋: KHIEUKH-YE-CHIEUCH
농: KHIEUKH-YE-THIEUTH
높: KHIEUKH-O-NIEUNCIEUC
놓: KHIEUKH-O-NIEUNHIEUH
놔: KHIEUKH-O-TIKEUT
놘: KHIEUKH-O-RIEULSIOS
놜: KHIEUKH-O-PIEUPSIOS
놨: KIYEOK-WAE-PIEUP
뇌: KIYEOK-WE-SIOS
뇐: KIYEOK-WI-RIEUL
뇔: KIYEOK-YU
뇜: KIYEOK-EU-RIEULKIYEOK
뇝: KIYEOK-EU-MIEUM
뇟: KIYEOK-EU-SIOS
뇨: KIYEOK-I-MIEUM
뇩: KIYEOK-I-PIEUP
뇬: KIYEOK-I-CIEUC
뇰: SSANGKIYEOK-A-SSANGKIYEOK
뇹: SSANGKIYEOK-A-THIEUTH
뇻: SSANGKIYEOK-AE-KIYEOK
뇽: SSANGKIYEOK-AE-RIEUL
누: NIEUN-U
눅: NIEUN-U-KIYEOK
눈: NIEUN-U-NIEUN
눋: NIEUN-U-TIKEUT
눌: NIEUN-U-RIEUL
눔: NIEUN-U-MIEUM
눕: NIEUN-U-PIEUP
눗: NIEUN-U-SIOS
눙: NIEUN-U-IEUNG
눠: NIEUN-WEO
눴: NIEUN-WEO-SSANGSIOS
눼: NIEUN-WE
뉘: KHIEUKH-WA-PHIEUPH
뉜: NIEUN-WI-NIEUN
뉠: NIEUN-WI-RIEUL
뉨: KHIEUKH-WAE-RIEULKIYEOK
뉩: KHIEUKH-WAE-RIEULMIEUM
뉴: KHIEUKH-WAE-CIEUC
뉵: KHIEUKH-WAE-CHIEUCH
뉼: NIEUN-YU-RIEUL
늄: KHIEUKH-OE-NIEUNCIEUC
늅: KHIEUKH-OE-NIEUNHIEUH
늉: KHIEUKH-OE-RIEULPIEUP
느: KHIEUKH-OE-PIEUPSIOS
늑: KHIEUKH-OE-SIOS
는: KHIEUKH-OE-CIEUC
늘: KHIEUKH-OE-PHIEUPH
늙: KHIEUKH-OE-HIEUH
늚: KHIEUKH-YO-KIYEOK
늠: KHIEUKH-YO-TIKEUT
늡: SSANGKIYEOK-AE-PIEUP
늣: SSANGKIYEOK-AE-SSANGSIOS
능: SSANGKIYEOK-YA
늦: SSANGKIYEOK-YA-KIYEOK
늪: SSANGKIYEOK-EO-SSANGKIYEOK
늬: SSANGKIYEOK-EO-RIEUL
늰: SSANGKIYEOK-EO-SSANGSIOS
늴: SSANGKIYEOK-E-NIEUN
니: SSANGKIYEOK-O-CIEUC
닉: SSANGKIYEOK-O-CHIEUCH
닌: SSANGKIYEOK-WA-RIEUL
닐: SSANGKIYEOK-WAE-KIYEOK
닒: SSANGKIYEOK-OE
님: SSANGKIYEOK-YO
닙: SSANGKIYEOK-U
닛: SSANGKIYEOK-U-NIEUN
닝: SSANGKIYEOK-U-RIEULHIEUH
닢: SSANGKIYEOK-U-CIEUC
다: SSANGKIYEOK-WEO-RIEUL
닥: SSANGKIYEOK-WEO-SSANGSIOS
닦: SSANGKIYEOK-WEO-IEUNG
단: SSANGKIYEOK-WE-KIYEOK
닫: SSANGKIYEOK-WE-MIEUM
달: SSANGKIYEOK-WE-PIEUP
닭: SSANGKIYEOK-WE-SSANGSIOS
닮: SSANGKIYEOK-WI
닯: SSANGKIYEOK-WI-NIEUN
닳: SSANGKIYEOK-YU
담: SSANGKIYEOK-EU
답: SSANGKIYEOK-EU-KIYEOK
닷: SSANGKIYEOK-EU-NIEUNHIEUH
닸: SSANGKIYEOK-EU-RIEUL
당: SSANGKIYEOK-EU-RIEULMIEUM
닺: SSANGKIYEOK-EU-RIEULHIEUH
닻: SSANGKIYEOK-EU-MIEUM
닿: TIKEUT-A-HIEUH
대: TIKEUT-AE
댁: TIKEUT-AE-KIYEOK
댄: TIKEUT-AE-NIEUN
댈: TIKEUT-AE-RIEUL
댐: TIKEUT-AE-MIEUM
댑: TIKEUT-AE-PIEUP
댓: TIKEUT-AE-SIOS
댔: TIKEUT-AE-SSANGSIOS
댕: TIKEUT-AE-IEUNG
댜: TIKEUT-YA
더: KHIEUKH-YO-HIEUH
덕: KHIEUKH-U-SSANGKIYEOK
덖: KHIEUKH-U-KIYEOKSIOS
던: KHIEUKH-U-NIEUNHIEUH
덛: TIKEUT-EO-TIKEUT
덜: TIKEUT-EO-RIEUL
덞: TIKEUT-EO-RIEULMIEUM
덟: TIKEUT-EO-RIEULPIEUP
덤: KHIEUKH-U-RIEULTHIEUTH
덥: KHIEUKH-U-RIEULPHIEUPH
덧: KHIEUKH-U-PIEUPSIOS
덩: KHIEUKH-U-CIEUC
덫: KHIEUKH-U-KHIEUKH
덮: KHIEUKH-U-HIEUH
데: KHIEUKH-WEO-SSANGKIYEOK
덱: KHIEUKH-WEO-KIYEOKSIOS
덴: KHIEUKH-WEO-TIKEUT
델: KHIEUKH-WEO-RIEULSIOS
뎀: TIKEUT-E-MIEUM
뎁: KHIEUKH-WEO-RIEULHIEUH
뎃: KHIEUKH-WEO-PIEUP
뎄: KHIEUKH-WEO-PIEUPSIOS
뎅: KHIEUKH-WEO-SIOS
뎌: KHIEUKH-WEO-HIEUH
뎐: KHIEUKH-WE-NIEUN
뎔: KHIEUKH-WE-RIEUL
뎠: KHIEUKH-WE-SSANGSIOS
뎡: SSANGKIYEOK-EU-THIEUTH
뎨: SSANGKIYEOK-I-SIOS
뎬: NIEUN-A-SSANGKIYEOK
도: NIEUN-YA
독: NIEUN-YA-KIYEOK
돈: NIEUN-YA-MIEUM
돋: NIEUN-EO-KIYEOK
돌: NIEUN-EO-KIYEOKSIOS
돎: NIEUN-EO-RIEUL
돐: NIEUN-EO-RIEULPIEUP
돔: NIEUN-EO-SSANGSIOS
돕: NIEUN-EO-IEUNG
돗: NIEUN-E
동: NIEUN-E-NIEUN
돛: NIEUN-E-MIEUM
돝: NIEUN-E-SIOS
돠: NIEUN-YEO
돤: NIEUN-YEO-MIEUM
돨: NIEUN-YEO-KHIEUKH
돼: NIEUN-OE-RIEUL
됐: TIKEUT-WAE-SSANGSIOS
되: TIKEUT-OE
된: TIKEUT-OE-NIEUN
될: TIKEUT-OE-RIEUL
됨: TIKEUT-OE-MIEUM
됩: TIKEUT-OE-PIEUP
됫: TIKEUT-OE-SIOS
됴: TIKEUT-YO
두: KHIEUKH-WI-RIEULTHIEUTH
둑: KHIEUKH-WI-RIEULPHIEUPH
둔: KHIEUKH-WI-SSANGSIOS
둘: KHIEUKH-WI-THIEUTH
둠: TIKEUT-U-MIEUM
둡: KHIEUKH-YU-KIYEOK
둣: KHIEUKH-YU-KIYEOKSIOS
둥: KHIEUKH-YU-NIEUNHIEUH
둬: KHIEUKH-YU-RIEULPHIEUPH
뒀: TIKEUT-WEO-SSANGSIOS
뒈: KHIEUKH-EU-RIEULTHIEUTH
뒝: KHIEUKH-YI-RIEULKIYEOK
뒤: NIEUN-YO-NIEUN
뒨: NIEUN-YO-IEUNG
뒬: NIEUN-U-TIKEUT
뒵: NIEUN-WI
뒷: NIEUN-WI-RIEUL
뒹: NIEUN-WI-PIEUP
듀: NIEUN-EU
듄: NIEUN-EU-RIEULKIYEOK
듈: NIEUN-EU-SIOS
듐: NIEUN-I-KIYEOK
듕: NIEUN-I-PIEUP
드: TIKEUT-A-NIEUN
득: TIKEUT-A-TIKEUT
든: TIKEUT-A-RIEULMIEUM
듣: TIKEUT-A-MIEUM
들: TIKEUT-A-PIEUP
듦: TIKEUT-A-SSANGSIOS
듬: TIKEUT-AE-KIYEOK
듭: TIKEUT-AE-NIEUN
듯: TIKEUT-AE-MIEUM
등: TIKEUT-AE-SIOS
듸: TIKEUT-EO-NIEUN
디: TIKEUT-I
딕: TIKEUT-I-KIYEOK
딘: TIKEUT-I-NIEUN
딛: TIKEUT-I-TIKEUT
딜: TIKEUT-I-RIEUL
딤: TIKEUT-I-MIEUM
딥: TIKEUT-I-PIEUP
딧: TIKEUT-I-SIOS
딨: TIKEUT-I-SSANGSIOS
딩: TIKEUT-I-IEUNG
딪: TIKEUT-I-CIEUC
따: SSANGTIKEUT-A
딱: SSANGTIKEUT-A-KIYEOK
딴: SSANGTIKEUT-A-NIEUN
딸: SSANGTIKEUT-A-RIEUL
땀: SSANGTIKEUT-A-MIEUM
땁: KHIEUKH-YI-RIEULTHIEUTH
땃: KHIEUKH-YI-RIEULHIEUH
땄: KHIEUKH-YI-MIEUM
땅: KHIEUKH-YI-PIEUP
땋: KHIEUKH-YI-CHIEUCH
때: KHIEUKH-YI-KHIEUKH
땍: KHIEUKH-YI-THIEUTH
땐: KHIEUKH-I-SSANGKIYEOK
땔: KHIEUKH-I-TIKEUT
땜: SSANGTIKEUT-AE-MIEUM
땝: SSANGTIKEUT-AE-PIEUP
땟: SSANGTIKEUT-AE-SIOS
땠: SSANGTIKEUT-AE-SSANGSIOS
땡: KHIEUKH-I-RIEULHIEUH
떠: THIEUTH-YA-RIEULSIOS
떡: TIKEUT-EO-SIOS
떤: TIKEUT-EO-PHIEUPH
떨: TIKEUT-E-RIEUL
떪: TIKEUT-E-PIEUP
떫: TIKEUT-E-SIOS
떰: TIKEUT-YEO-RIEUL
떱: TIKEUT-YEO-SSANGSIOS
떳: TIKEUT-YE
떴: TIKEUT-YE-NIEUN
떵: TIKEUT-O
떻: TIKEUT-O-RIEULSIOS
떼: TIKEUT-O-MIEUM
떽: TIKEUT-O-PIEUP
뗀: TIKEUT-O-CHIEUCH
뗄: TIKEUT-WA-RIEUL
뗌: TIKEUT-OE-SIOS
뗍: TIKEUT-YO
뗏: TIKEUT-U-KIYEOK
뗐: TIKEUT-U-NIEUN
뗑: TIKEUT-U-RIEUL
뗘: TIKEUT-WE
뗬: TIKEUT-EU-PIEUP
또: SSANGTIKEUT-O
똑: SSANGTIKEUT-O-KIYEOK
똔: SSANGTIKEUT-O-NIEUN
똘: SSANGTIKEUT-O-RIEUL
똥: SSANGTIKEUT-O-IEUNG
똬: SSANGTIKEUT-WA
똴: SSANGTIKEUT-WA-RIEUL
뙈: THIEUTH-YA-SSANGSIOS
뙤: THIEUTH-YAE-RIEULHIEUH
뙨: THIEUTH-YAE-SIOS
뚜: THIEUTH-E-HIEUH
뚝: THIEUTH-YEO-KIYEOK
뚠: THIEUTH-YEO-NIEUNCIEUC
뚤: SSANGTIKEUT-A-SSANGSIOS
뚫: SSANGTIKEUT-AE-MIEUM
뚬: SSANGTIKEUT-AE-PIEUP
뚱: SSANGTIKEUT-EO-KIYEOK
뛔: SSANGTIKEUT-U-RIEUL
뛰: SSANGTIKEUT-WI
뛴: SSANGTIKEUT-WI-NIEUN
뛸: SSANGTIKEUT-WI-RIEUL
뜀: SSANGTIKEUT-WI-MIEUM
뜁: SSANGTIKEUT-WI-PIEUP
뜅: SSANGTIKEUT-WI-IEUNG
뜨: SSANGTIKEUT-EU
뜩: SSANGTIKEUT-EU-KIYEOK
뜬: SSANGTIKEUT-EU-NIEUN
뜯: SSANGTIKEUT-EU-TIKEUT
뜰: SSANGTIKEUT-EU-RIEUL
뜸: SSANGTIKEUT-EU-MIEUM
뜹: SSANGTIKEUT-EU-PIEUP
뜻: SSANGTIKEUT-EU-SIOS
띄: SSANGTIKEUT-YI
띈: SSANGTIKEUT-YI-NIEUN
띌: SSANGTIKEUT-YI-RIEUL
띔: SSANGTIKEUT-YI-MIEUM
띕: SSANGTIKEUT-YI-PIEUP
띠: SSANGTIKEUT-I
띤: SSANGTIKEUT-I-NIEUN
띨: SSANGTIKEUT-I-RIEUL
띰: SSANGTIKEUT-I-MIEUM
띱: SSANGTIKEUT-I-PIEUP
띳: SSANGTIKEUT-I-SIOS
띵: SSANGTIKEUT-I-IEUNG
라: RIEUL-A
락: RIEUL-A-KIYEOK
란: RIEUL-A-NIEUN
랄: RIEUL-A-RIEUL
람: RIEUL-A-MIEUM
랍: RIEUL-A-PIEUP
랏: RIEUL-A-SIOS
랐: RIEUL-A-SSANGSIOS
랑: RIEUL-A-IEUNG
랒: RIEUL-A-CIEUC
랖: RIEUL-A-PHIEUPH
랗: RIEUL-A-HIEUH
래: THIEUTH-WA-RIEULPIEUP
랙: THIEUTH-WA-RIEULSIOS
랜: THIEUTH-WA-RIEULHIEUH
랠: THIEUTH-WA-SIOS
램: RIEUL-AE-MIEUM
랩: RIEUL-AE-PIEUP
랫: RIEUL-AE-SIOS
랬: RIEUL-AE-SSANGSIOS
랭: RIEUL-AE-IEUNG
랴: RIEUL-YA
략: RIEUL-YA-KIYEOK
랸: RIEUL-YA-NIEUN
럇: RIEUL-YA-SIOS
량: RIEUL-YA-IEUNG
러: RIEUL-EO
럭: RIEUL-EO-KIYEOK
런: RIEUL-EO-NIEUN
럴: RIEUL-EO-RIEUL
럼: RIEUL-EO-MIEUM
럽: RIEUL-EO-PIEUP
럿: RIEUL-EO-SIOS
렀: RIEUL-EO-SSANGSIOS
렁: RIEUL-EO-IEUNG
렇: RIEUL-EO-HIEUH
레: RIEUL-E
렉: RIEUL-E-KIYEOK
렌: RIEUL-E-NIEUN
렐: RIEUL-E-RIEUL
렘: RIEUL-E-MIEUM
렙: RIEUL-E-PIEUP
렛: RIEUL-E-SIOS
렝: RIEUL-E-IEUNG
려: RIEUL-YEO
력: RIEUL-YEO-KIYEOK
련: RIEUL-YEO-NIEUN
렬: RIEUL-YEO-RIEUL
렴: RIEUL-YEO-MIEUM
렵: RIEUL-YEO-PIEUP
렷: RIEUL-YEO-SIOS
렸: RIEUL-YEO-SSANGSIOS
령: RIEUL-YEO-IEUNG
례: RIEUL-YE
롄: RIEUL-YE-NIEUN
롑: RIEUL-YE-PIEUP
롓: RIEUL-YE-SIOS
로: RIEUL-O
록: RIEUL-O-KIYEOK
론: RIEUL-O-NIEUN
롤: RIEUL-O-RIEUL
롬: RIEUL-O-MIEUM
롭: RIEUL-O-PIEUP
롯: RIEUL-O-SIOS
롱: RIEUL-O-IEUNG
롸: RIEUL-WA
롼: RIEUL-WA-NIEUN
뢍: RIEUL-WA-IEUNG
뢨: RIEUL-WAE-SSANGSIOS
뢰: RIEUL-OE
뢴: RIEUL-OE-NIEUN
뢸: RIEUL-OE-RIEUL
룀: RIEUL-OE-MIEUM
룁: RIEUL-OE-PIEUP
룃: RIEUL-OE-SIOS
룅: RIEUL-OE-IEUNG
료: RIEUL-YO
룐: RIEUL-YO-NIEUN
룔: RIEUL-YO-RIEUL
룝: RIEUL-YO-PIEUP
룟: RIEUL-YO-SIOS
룡: RIEUL-YO-IEUNG
루: RIEUL-U
룩: RIEUL-U-KIYEOK
룬: RIEUL-U-NIEUN
룰: RIEUL-U-RIEUL
룸: RIEUL-U-MIEUM
룹: RIEUL-U-PIEUP
룻: RIEUL-U-SIOS
룽: RIEUL-U-IEUNG
뤄: RIEUL-WEO
뤘: RIEUL-WEO-SSANGSIOS
뤠: RIEUL-WE
뤼: RIEUL-WI
뤽: RIEUL-WI-KIYEOK
륀: RIEUL-WI-NIEUN
륄: RIEUL-WI-RIEUL
륌: RIEUL-WI-MIEUM
륏: RIEUL-WI-SIOS
륑: RIEUL-WI-IEUNG
류: RIEUL-YU
륙: RIEUL-YU-KIYEOK
륜: RIEUL-YU-NIEUN
률: RIEUL-YU-RIEUL
륨: RIEUL-YU-MIEUM
륩: RIEUL-YU-PIEUP
륫: RIEUL-YU-SIOS
륭: RIEUL-YU-IEUNG
르: RIEUL-EU
륵: RIEUL-EU-KIYEOK
른: RIEUL-EU-NIEUN
를: RIEUL-EU-RIEUL
름: RIEUL-EU-MIEUM
릅: RIEUL-EU-PIEUP
릇: RIEUL-EU-SIOS
릉: RIEUL-EU-IEUNG
릊: RIEUL-EU-CIEUC
릍: RIEUL-EU-THIEUTH
릎: RIEUL-EU-PHIEUPH
리: RIEUL-I
릭: RIEUL-I-KIYEOK
린: RIEUL-I-NIEUN
릴: RIEUL-I-RIEUL
림: RIEUL-I-MIEUM
립: RIEUL-I-PIEUP
릿: RIEUL-I-SIOS
링: RIEUL-I-IEUNG
마: MIEUM-A
막: MIEUM-A-KIYEOK
만: MIEUM-A-NIEUN
많: MIEUM-A-NIEUNHIEUH
맏: MIEUM-A-TIKEUT
말: MIEUM-A-RIEUL
맑: MIEUM-A-RIEULKIYEOK
맒: MIEUM-A-RIEULMIEUM
맘: MIEUM-A-MIEUM
맙: MIEUM-A-PIEUP
맛: MIEUM-A-SIOS
망: MIEUM-A-IEUNG
맞: MIEUM-A-CIEUC
맡: MIEUM-A-THIEUTH
맣: MIEUM-A-HIEUH
매: MIEUM-AE
맥: MIEUM-AE-KIYEOK
맨: MIEUM-AE-NIEUN
맬: MIEUM-AE-RIEUL
맴: MIEUM-AE-MIEUM
맵: MIEUM-AE-PIEUP
맷: MIEUM-AE-SIOS
맸: MIEUM-AE-SSANGSIOS
맹: MIEUM-AE-IEUNG
맺: MIEUM-AE-CIEUC
먀: MIEUM-YA
먁: MIEUM-YA-KIYEOK
먈: MIEUM-YA-RIEUL
먕: MIEUM-YA-IEUNG
머: MIEUM-EO
먹: MIEUM-EO-KIYEOK
먼: MIEUM-EO-NIEUN
멀: MIEUM-EO-RIEUL
멂: MIEUM-EO-RIEULMIEUM
멈: MIEUM-EO-MIEUM
멉: MIEUM-EO-PIEUP
멋: MIEUM-EO-SIOS
멍: MIEUM-EO-IEUNG
멎: MIEUM-EO-CIEUC
멓: MIEUM-EO-HIEUH
메: MIEUM-E
멕: MIEUM-E-KIYEOK
멘: MIEUM-E-NIEUN
멜: MIEUM-E-RIEUL
멤: MIEUM-E-MIEUM
멥: MIEUM-E-PIEUP
멧: MIEUM-E-SIOS
멨: MIEUM-E-SSANGSIOS
멩: MIEUM-E-IEUNG
며: MIEUM-YEO
멱: MIEUM-YEO-KIYEOK
면: MIEUM-YEO-NIEUN
멸: MIEUM-YEO-RIEUL
몃: MIEUM-YEO-SIOS
몄: MIEUM-YEO-SSANGSIOS
명: MIEUM-YEO-IEUNG
몇: MIEUM-YEO-CHIEUCH
몌: MIEUM-YE
모: MIEUM-O
목: MIEUM-O-KIYEOK
몫: MIEUM-O-KIYEOKSIOS
몬: MIEUM-O-NIEUN
몰: MIEUM-O-RIEUL
몲: MIEUM-O-RIEULMIEUM
몸: MIEUM-O-MIEUM
몹: MIEUM-O-PIEUP
못: MIEUM-O-SIOS
몽: MIEUM-O-IEUNG
뫄: MIEUM-WA
뫈: MIEUM-WA-NIEUN
뫘: MIEUM-WA-SSANGSIOS
뫙: MIEUM-WA-IEUNG
뫼: MIEUM-OE
묀: MIEUM-OE-NIEUN
묄: MIEUM-OE-RIEUL
묍: MIEUM-OE-PIEUP
묏: MIEUM-OE-SIOS
묑: MIEUM-OE-IEUNG
묘: MIEUM-YO
묜: MIEUM-YO-NIEUN
묠: MIEUM-YO-RIEUL
묩: MIEUM-YO-PIEUP
묫: MIEUM-YO-SIOS
무: MIEUM-U
묵: MIEUM-U-KIYEOK
묶: MIEUM-U-SSANGKIYEOK
문: MIEUM-U-NIEUN
묻: MIEUM-U-TIKEUT
물: MIEUM-U-RIEUL
묽: MIEUM-U-RIEULKIYEOK
묾: MIEUM-U-RIEULMIEUM
뭄: MIEUM-U-MIEUM
뭅: MIEUM-U-PIEUP
뭇: MIEUM-U-SIOS
뭉: MIEUM-U-IEUNG
뭍: MIEUM-U-THIEUTH
뭏: MIEUM-U-HIEUH
뭐: MIEUM-WEO
뭔: MIEUM-WEO-NIEUN
뭘: MIEUM-WEO-RIEUL
뭡: MIEUM-WEO-PIEUP
뭣: MIEUM-WEO-SIOS
뭬: MIEUM-WE
뮈: MIEUM-WI
뮌: MIEUM-WI-NIEUN
뮐: MIEUM-WI-RIEUL
뮤: MIEUM-YU
뮨: MIEUM-YU-NIEUN
뮬: MIEUM-YU-RIEUL
뮴: MIEUM-YU-MIEUM
뮷: MIEUM-YU-SIOS
므: MIEUM-EU
믄: MIEUM-EU-NIEUN
믈: MIEUM-EU-RIEUL
믐: MIEUM-EU-MIEUM
믓: MIEUM-EU-SIOS
미: MIEUM-I
믹: MIEUM-I-KIYEOK
민: MIEUM-I-NIEUN
믿: MIEUM-I-TIKEUT
밀: MIEUM-I-RIEUL
밂: MIEUM-I-RIEULMIEUM
밈: MIEUM-I-MIEUM
밉: MIEUM-I-PIEUP
밋: MIEUM-I-SIOS
밌: MIEUM-I-SSANGSIOS
밍: MIEUM-I-IEUNG
및: MIEUM-I-CHIEUCH
밑: MIEUM-I-THIEUTH
바: PIEUP-A
박: PIEUP-A-KIYEOK
밖: PIEUP-A-SSANGKIYEOK
밗: PIEUP-A-KIYEOKSIOS
반: PIEUP-A-NIEUN
받: PIEUP-A-TIKEUT
발: PIEUP-A-RIEUL
밝: PIEUP-A-RIEULKIYEOK
밞: PIEUP-A-RIEULMIEUM
밟: PIEUP-A-RIEULPIEUP
밤: PIEUP-A-MIEUM
밥: PIEUP-A-PIEUP
밧: PIEUP-A-SIOS
방: PIEUP-A-IEUNG
밭: PIEUP-A-THIEUTH
배: PIEUP-AE
백: PIEUP-AE-KIYEOK
밴: PIEUP-AE-NIEUN
밸: PIEUP-AE-RIEUL
뱀: PIEUP-AE-MIEUM
뱁: PIEUP-AE-PIEUP
뱃: PIEUP-AE-SIOS
뱄: PIEUP-AE-SSANGSIOS
뱅: PIEUP-AE-IEUNG
뱉: PIEUP-AE-THIEUTH
뱌: PIEUP-YA
뱍: PIEUP-YA-KIYEOK
뱐: PIEUP-YA-NIEUN
뱝: PIEUP-YA-PIEUP
버: PIEUP-EO
벅: PIEUP-EO-KIYEOK
번: PIEUP-EO-NIEUN
벋: PIEUP-EO-TIKEUT
벌: PIEUP-EO-RIEUL
벎: PIEUP-EO-RIEULMIEUM
범: PIEUP-EO-MIEUM
법: PIEUP-EO-PIEUP
벗: PIEUP-EO-SIOS
벙: PIEUP-EO-IEUNG
벚: PIEUP-EO-CIEUC
베: PIEUP-E
벡: PIEUP-E-KIYEOK
벤: PIEUP-E-NIEUN
벧: PIEUP-E-TIKEUT
벨: PIEUP-E-RIEUL
벰: PIEUP-E-MIEUM
벱: PIEUP-E-PIEUP
벳: PIEUP-E-SIOS
벴: PIEUP-E-SSANGSIOS
벵: PIEUP-E-IEUNG
벼: PIEUP-YEO
벽: PIEUP-YEO-KIYEOK
변: PIEUP-YEO-NIEUN
별: PIEUP-YEO-RIEUL
볍: PIEUP-YEO-PIEUP
볏: PIEUP-YEO-SIOS
볐: PIEUP-YEO-SSANGSIOS
병: PIEUP-YEO-IEUNG
볕: PIEUP-YEO-THIEUTH
볘: PIEUP-YE
볜: PIEUP-YE-NIEUN
보: PIEUP-O
복: PIEUP-O-KIYEOK
볶: PIEUP-O-SSANGKIYEOK
본: PIEUP-O-NIEUN
볼: PIEUP-O-RIEUL
봄: PIEUP-O-MIEUM
봅: PIEUP-O-PIEUP
봇: PIEUP-O-SIOS
봉: PIEUP-O-IEUNG
봐: PIEUP-WA
봔: PIEUP-WA-NIEUN
봤: PIEUP-WA-SSANGSIOS
봬: PIEUP-WAE
뵀: PIEUP-WAE-SSANGSIOS
뵈: PIEUP-OE
뵉: PIEUP-OE-KIYEOK
뵌: PIEUP-OE-NIEUN
뵐: PIEUP-OE-RIEUL
뵘: PIEUP-OE-MIEUM
뵙: PIEUP-OE-PIEUP
뵤: PIEUP-YO
뵨: PIEUP-YO-NIEUN
부: PIEUP-U
북: PIEUP-U-KIYEOK
분: PIEUP-U-NIEUN
붇: PIEUP-U-TIKEUT
불: PIEUP-U-RIEUL
붉: PIEUP-U-RIEULKIYEOK
붊: PIEUP-U-RIEULMIEUM
붐: PIEUP-U-MIEUM
붑: PIEUP-U-PIEUP
붓: PIEUP-U-SIOS
붕: PIEUP-U-IEUNG
붙: PIEUP-U-THIEUTH
붚: PIEUP-U-PHIEUPH
붜: PIEUP-WEO
붤: PIEUP-WEO-RIEUL
붰: PIEUP-WEO-SSANGSIOS
붸: PIEUP-WE
뷔: PIEUP-WI
뷕: PIEUP-WI-KIYEOK
뷘: PIEUP-WI-NIEUN
뷜: PIEUP-WI-RIEUL
뷩: PIEUP-WI-IEUNG
뷰: PIEUP-YU
뷴: PIEUP-YU-NIEUN
뷸: PIEUP-YU-RIEUL
븀: PIEUP-YU-MIEUM
븃: PIEUP-YU-SIOS
븅: PIEUP-YU-IEUNG
브: PIEUP-EU
븍: PIEUP-EU-KIYEOK
븐: PIEUP-EU-NIEUN
블: PIEUP-EU-RIEUL
븜: PIEUP-EU-MIEUM
븝: PIEUP-EU-PIEUP
븟: PIEUP-EU-SIOS
비: PIEUP-I
빅: PIEUP-I-KIYEOK
빈: PIEUP-I-NIEUN
빌: PIEUP-I-RIEUL
빎: PIEUP-I-RIEULMIEUM
빔: PIEUP-I-MIEUM
빕: PIEUP-I-PIEUP
빗: PIEUP-I-SIOS
빙: PIEUP-I-IEUNG
빚: PIEUP-I-CIEUC
빛: PIEUP-I-CHIEUCH
빠: SSANGPIEUP-A
빡: SSANGPIEUP-A-KIYEOK
빤: SSANGPIEUP-A-NIEUN
빨: SSANGPIEUP-A-RIEUL
빪: SSANGPIEUP-A-RIEULMIEUM
빰: SSANGPIEUP-A-MIEUM
빱: SSANGPIEUP-A-PIEUP
빳: SSANGPIEUP-A-SIOS
빴: SSANGPIEUP-A-SSANGSIOS
빵: SSANGPIEUP-A-IEUNG
빻: SSANGPIEUP-A-HIEUH
빼: SSANGPIEUP-AE
빽: SSANGPIEUP-AE-KIYEOK
뺀: SSANGPIEUP-AE-NIEUN
뺄: SSANGPIEUP-AE-RIEUL
뺌: SSANGPIEUP-AE-MIEUM
뺍: SSANGPIEUP-AE-PIEUP
뺏: SSANGPIEUP-AE-SIOS
뺐: SSANGPIEUP-AE-SSANGSIOS
뺑: SSANGPIEUP-AE-IEUNG
뺘: SSANGPIEUP-YA
뺙: SSANGPIEUP-YA-KIYEOK
뺨: SSANGPIEUP-YA-MIEUM
뻐: SSANGPIEUP-EO
뻑: SSANGPIEUP-EO-KIYEOK
뻔: SSANGPIEUP-EO-NIEUN
뻗: SSANGPIEUP-EO-TIKEUT
뻘: SSANGPIEUP-EO-RIEUL
뻠: SSANGPIEUP-EO-MIEUM
뻣: SSANGPIEUP-EO-SIOS
뻤: SSANGPIEUP-EO-SSANGSIOS
뻥: SSANGPIEUP-EO-IEUNG
뻬: SSANGPIEUP-E
뼁: SSANGPIEUP-E-IEUNG
뼈: SSANGPIEUP-YEO
뼉: SSANGPIEUP-YEO-KIYEOK
뼘: SSANGPIEUP-YEO-MIEUM
뼙: SSANGPIEUP-YEO-PIEUP
뼛: SSANGPIEUP-YEO-SIOS
뼜: SSANGPIEUP-YEO-SSANGSIOS
뼝: SSANGPIEUP-YEO-IEUNG
뽀: SSANGPIEUP-O
뽁: SSANGPIEUP-O-KIYEOK
뽄: SSANGPIEUP-O-NIEUN
뽈: SSANGPIEUP-O-RIEUL
뽐: SSANGPIEUP-O-MIEUM
뽑: SSANGPIEUP-O-PIEUP
뽕: SSANGPIEUP-O-IEUNG
뾔: SSANGPIEUP-OE
뾰: SSANGPIEUP-YO
뿅: SSANGPIEUP-YO-IEUNG
뿌: SSANGPIEUP-U
뿍: SSANGPIEUP-U-KIYEOK
뿐: SSANGPIEUP-U-NIEUN
뿔: SSANGPIEUP-U-RIEUL
뿜: SSANGPIEUP-U-MIEUM
뿟: SSANGPIEUP-U-SIOS
뿡: SSANGPIEUP-U-IEUNG
쀼: SSANGPIEUP-YU
쁑: SSANGPIEUP-YU-IEUNG
쁘: SSANGPIEUP-EU
쁜: SSANGPIEUP-EU-NIEUN
쁠: SSANGPIEUP-EU-RIEUL
쁨: SSANGPIEUP-EU-MIEUM
쁩: SSANGPIEUP-EU-PIEUP
삐: SSANGPIEUP-I
삑: SSANGPIEUP-I-KIYEOK
삔: SSANGPIEUP-I-NIEUN
삘: SSANGPIEUP-I-RIEUL
삠: SSANGPIEUP-I-MIEUM
삡: SSANGPIEUP-I-PIEUP
삣: SSANGPIEUP-I-SIOS
삥: SSANGPIEUP-I-IEUNG
사: SIOS-A
삭: SIOS-A-KIYEOK
삯: SIOS-A-KIYEOKSIOS
산: SIOS-A-NIEUN
삳: SIOS-A-TIKEUT
살: SIOS-A-RIEUL
삵: SIOS-A-RIEULKIYEOK
삶: SIOS-A-RIEULMIEUM
삼: SIOS-A-MIEUM
삽: SIOS-A-PIEUP
삿: SIOS-A-SIOS
샀: SIOS-A-SSANGSIOS
상: SIOS-A-IEUNG
샅: SIOS-A-THIEUTH
새: SIOS-AE
색: SIOS-AE-KIYEOK
샌: SIOS-AE-NIEUN
샐: SIOS-AE-RIEUL
샘: SIOS-AE-MIEUM
샙: SIOS-AE-PIEUP
샛: SIOS-AE-SIOS
샜: SIOS-AE-SSANGSIOS
생: SIOS-AE-IEUNG
샤: SIOS-YA
샥: SIOS-YA-KIYEOK
샨: SIOS-YA-NIEUN
샬: SIOS-YA-RIEUL
샴: SIOS-YA-MIEUM
샵: SIOS-YA-PIEUP
샷: SIOS-YA-SIOS
샹: SIOS-YA-IEUNG
섀: SIOS-YAE
섄: SIOS-YAE-NIEUN
섈: SIOS-YAE-RIEUL
섐: SIOS-YAE-MIEUM
섕: SIOS-YAE-IEUNG
서: SIOS-EO
석: SIOS-EO-KIYEOK
섞: SIOS-EO-SSANGKIYEOK
섟: SIOS-EO-KIYEOKSIOS
선: SIOS-EO-NIEUN
섣: SIOS-EO-TIKEUT
설: SIOS-EO-RIEUL
섦: SIOS-EO-RIEULMIEUM
섧: SIOS-EO-RIEULPIEUP
섬: SIOS-EO-MIEUM
섭: SIOS-EO-PIEUP
섯: SIOS-EO-SIOS
섰: SIOS-EO-SSANGSIOS
성: SIOS-EO-IEUNG
섶: SIOS-EO-PHIEUPH
세: SIOS-E
섹: SIOS-E-KIYEOK
센: SIOS-E-NIEUN
셀: SIOS-E-RIEUL
셈: SIOS-E-MIEUM
셉: SIOS-E-PIEUP
셋: SIOS-E-SIOS
셌: SIOS-E-SSANGSIOS
셍: SIOS-E-IEUNG
셔: SIOS-YEO
셕: SIOS-YEO-KIYEOK
션: SIOS-YEO-NIEUN
셜: SIOS-YEO-RIEUL
셤: SIOS-YEO-MIEUM
셥: SIOS-YEO-PIEUP
셧: SIOS-YEO-SIOS
셨: SIOS-YEO-SSANGSIOS
셩: SIOS-YEO-IEUNG
셰: SIOS-YE
셴: SIOS-YE-NIEUN
셸: SIOS-YE-RIEUL
솅: SIOS-YE-IEUNG
소: SIOS-O
속: SIOS-O-KIYEOK
솎: SIOS-O-SSANGKIYEOK
손: SIOS-O-NIEUN
솔: SIOS-O-RIEUL
솖: SIOS-O-RIEULMIEUM
솜: SIOS-O-MIEUM
솝: SIOS-O-PIEUP
솟: SIOS-O-SIOS
송: SIOS-O-IEUNG
솥: SIOS-O-THIEUTH
솨: SIOS-WA
솩: SIOS-WA-KIYEOK
솬: SIOS-WA-NIEUN
솰: SIOS-WA-RIEUL
솽: SIOS-WA-IEUNG
쇄: SIOS-WAE
쇈: SIOS-WAE-NIEUN
쇌: SIOS-WAE-RIEUL
쇔: SIOS-WAE-MIEUM
쇗: SIOS-WAE-SIOS
쇘: SIOS-WAE-SSANGSIOS
쇠: SIOS-OE
쇤: SIOS-OE-NIEUN
쇨: SIOS-OE-RIEUL
쇰: SIOS-OE-MIEUM
쇱: SIOS-OE-PIEUP
쇳: SIOS-OE-SIOS
쇼: SIOS-YO
쇽: SIOS-YO-KIYEOK
숀: SIOS-YO-NIEUN
숄: SIOS-YO-RIEUL
숌: SIOS-YO-MIEUM
숍: SIOS-YO-PIEUP
숏: SIOS-YO-SIOS
숑: SIOS-YO-IEUNG
수: SIOS-U
숙: SIOS-U-KIYEOK
순: SIOS-U-NIEUN
숟: SIOS-U-TIKEUT
술: SIOS-U-RIEUL
숨: SIOS-U-MIEUM
숩: SIOS-U-PIEUP
숫: SIOS-U-SIOS
숭: SIOS-U-IEUNG
숯: SIOS-U-CHIEUCH
숱: SIOS-U-THIEUTH
숲: SIOS-U-PHIEUPH
숴: SIOS-WEO
쉈: SIOS-WEO-SSANGSIOS
쉐: SIOS-WE
쉑: SIOS-WE-KIYEOK
쉔: SIOS-WE-NIEUN
쉘: SIOS-WE-RIEUL
쉠: SIOS-WE-MIEUM
쉥: SIOS-WE-IEUNG
쉬: SIOS-WI
쉭: SIOS-WI-KIYEOK
쉰: SIOS-WI-NIEUN
쉴: SIOS-WI-RIEUL
쉼: SIOS-WI-MIEUM
쉽: SIOS-WI-PIEUP
쉿: SIOS-WI-SIOS
슁: SIOS-WI-IEUNG
슈: SIOS-YU
슉: SIOS-YU-KIYEOK
슐: SIOS-YU-RIEUL
슘: SIOS-YU-MIEUM
슛: SIOS-YU-SIOS
슝: SIOS-YU-IEUNG
스: SIOS-EU
슥: SIOS-EU-KIYEOK
슨: SIOS-EU-NIEUN
슬: SIOS-EU-RIEUL
슭: SIOS-EU-RIEULKIYEOK
슴: SIOS-EU-MIEUM
습: SIOS-EU-PIEUP
슷: SIOS-EU-SIOS
승: SIOS-EU-IEUNG
시: SIOS-I
식: SIOS-I-KIYEOK
신: SIOS-I-NIEUN
싣: SIOS-I-TIKEUT
실: SIOS-I-RIEUL
싫: SIOS-I-RIEULHIEUH
심: SIOS-I-MIEUM
십: SIOS-I-PIEUP
싯: SIOS-I-SIOS
싱: SIOS-I-IEUNG
싶: SIOS-I-PHIEUPH
싸: SSANGSIOS-A
싹: SSANGSIOS-A-KIYEOK
싻: SSANGSIOS-A-KIYEOKSIOS
싼: SSANGSIOS-A-NIEUN
쌀: SSANGSIOS-A-RIEUL
쌈: SSANGSIOS-A-MIEUM
쌉: SSANGSIOS-A-PIEUP
쌌: SSANGSIOS-A-SSANGSIOS
쌍: SSANGSIOS-A-IEUNG
쌓: SSANGSIOS-A-HIEUH
쌔: SSANGSIOS-AE
쌕: SSANGSIOS-AE-KIYEOK
쌘: SSANGSIOS-AE-NIEUN
쌜: SSANGSIOS-AE-RIEUL
쌤: SSANGSIOS-AE-MIEUM
쌥: SSANGSIOS-AE-PIEUP
쌨: SSANGSIOS-AE-SSANGSIOS
쌩: SSANGSIOS-AE-IEUNG
썅: SSANGSIOS-YA-IEUNG
써: SSANGSIOS-EO
썩: SSANGSIOS-EO-KIYEOK
썬: SSANGSIOS-EO-NIEUN
썰: SSANGSIOS-EO-RIEUL
썲: SSANGSIOS-EO-RIEULMIEUM
썸: SSANGSIOS-EO-MIEUM
썹: SSANGSIOS-EO-PIEUP
썼: SSANGSIOS-EO-SSANGSIOS
썽: SSANGSIOS-EO-IEUNG
쎄: SSANGSIOS-E
쎈: SSANGSIOS-E-NIEUN
쎌: SSANGSIOS-E-RIEUL
쏀: SSANGSIOS-YE-NIEUN
쏘: SSANGSIOS-O
쏙: SSANGSIOS-O-KIYEOK
쏜: SSANGSIOS-O-NIEUN
쏟: SSANGSIOS-O-TIKEUT
쏠: SSANGSIOS-O-RIEUL
쏢: SSANGSIOS-O-RIEULMIEUM
쏨: SSANGSIOS-O-MIEUM
쏩: SSANGSIOS-O-PIEUP
쏭: SSANGSIOS-O-IEUNG
쏴: SSANGSIOS-WA
쏵: SSANGSIOS-WA-KIYEOK
쏸: SSANGSIOS-WA-NIEUN
쐈: SSANGSIOS-WA-SSANGSIOS
쐐: SSANGSIOS-WAE
쐤: SSANGSIOS-WAE-SSANGSIOS
쐬: SSANGSIOS-OE
쐰: SSANGSIOS-OE-NIEUN
쐴: SSANGSIOS-OE-RIEUL
쐼: SSANGSIOS-OE-MIEUM
쐽: SSANGSIOS-OE-PIEUP
쑈: SSANGSIOS-YO
쑤: SSANGSIOS-U
쑥: SSANGSIOS-U-KIYEOK
쑨: SSANGSIOS-U-NIEUN
쑬: SSANGSIOS-U-RIEUL
쑴: SSANGSIOS-U-MIEUM
쑵: SSANGSIOS-U-PIEUP
쑹: SSANGSIOS-U-IEUNG
쒀: SSANGSIOS-WEO
쒔: SSANGSIOS-WEO-SSANGSIOS
쒜: SSANGSIOS-WE
쒸: SSANGSIOS-WI
쒼: SSANGSIOS-WI-NIEUN
쓩: SSANGSIOS-YU-IEUNG
쓰: SSANGSIOS-EU
쓱: SSANGSIOS-EU-KIYEOK
쓴: SSANGSIOS-EU-NIEUN
쓸: SSANGSIOS-EU-RIEUL
쓺: SSANGSIOS-EU-RIEULMIEUM
쓿: SSANGSIOS-EU-RIEULHIEUH
씀: SSANGSIOS-EU-MIEUM
씁: SSANGSIOS-EU-PIEUP
씌: SSANGSIOS-YI
씐: SSANGSIOS-YI-NIEUN
씔: SSANGSIOS-YI-RIEUL
씜: SSANGSIOS-YI-MIEUM
씨: SSANGSIOS-I
씩: SSANGSIOS-I-KIYEOK
씬: SSANGSIOS-I-NIEUN
씰: SSANGSIOS-I-RIEUL
씸: SSANGSIOS-I-MIEUM
씹: SSANGSIOS-I-PIEUP
씻: SSANGSIOS-I-SIOS
씽: SSANGSIOS-I-IEUNG
아: IEUNG-A
악: IEUNG-A-KIYEOK
안: IEUNG-A-NIEUN
앉: IEUNG-A-NIEUNCIEUC
않: IEUNG-A-NIEUNHIEUH
알: IEUNG-A-RIEUL
앍: IEUNG-A-RIEULKIYEOK
앎: IEUNG-A-RIEULMIEUM
앓: IEUNG-A-RIEULHIEUH
암: IEUNG-A-MIEUM
압: IEUNG-A-PIEUP
앗: IEUNG-A-SIOS
았: IEUNG-A-SSANGSIOS
앙: IEUNG-A-IEUNG
앝: IEUNG-A-THIEUTH
앞: IEUNG-A-PHIEUPH
애: IEUNG-AE
액: IEUNG-AE-KIYEOK
앤: IEUNG-AE-NIEUN
앨: IEUNG-AE-RIEUL
앰: IEUNG-AE-MIEUM
앱: IEUNG-AE-PIEUP
앳: IEUNG-AE-SIOS
앴: IEUNG-AE-SSANGSIOS
앵: IEUNG-AE-IEUNG
야: IEUNG-YA
약: IEUNG-YA-KIYEOK
얀: IEUNG-YA-NIEUN
얄: IEUNG-YA-RIEUL
얇: IEUNG-YA-RIEULPIEUP
얌: IEUNG-YA-MIEUM
얍: IEUNG-YA-PIEUP
얏: IEUNG-YA-SIOS
양: IEUNG-YA-IEUNG
얕: IEUNG-YA-THIEUTH
얗: IEUNG-YA-HIEUH
얘: IEUNG-YAE
얜: IEUNG-YAE-NIEUN
얠: IEUNG-YAE-RIEUL
얩: IEUNG-YAE-PIEUP
어: IEUNG-EO
억: IEUNG-EO-KIYEOK
언: IEUNG-EO-NIEUN
얹: IEUNG-EO-NIEUNCIEUC
얻: IEUNG-EO-TIKEUT
얼: IEUNG-EO-RIEUL
얽: IEUNG-EO-RIEULKIYEOK
얾: IEUNG-EO-RIEULMIEUM
엄: IEUNG-EO-MIEUM
업: IEUNG-EO-PIEUP
없: IEUNG-EO-PIEUPSIOS
엇: IEUNG-EO-SIOS
었: IEUNG-EO-SSANGSIOS
엉: IEUNG-EO-IEUNG
엊: IEUNG-EO-CIEUC
엌: IEUNG-EO-KHIEUKH
엎: IEUNG-EO-PHIEUPH
에: IEUNG-E
엑: IEUNG-E-KIYEOK
엔: IEUNG-E-NIEUN
엘: IEUNG-E-RIEUL
엠: IEUNG-E-MIEUM
엡: IEUNG-E-PIEUP
엣: IEUNG-E-SIOS
엥: IEUNG-E-IEUNG
여: IEUNG-YEO
역: IEUNG-YEO-KIYEOK
엮: IEUNG-YEO-SSANGKIYEOK
연: IEUNG-YEO-NIEUN
열: IEUNG-YEO-RIEUL
엶: IEUNG-YEO-RIEULMIEUM
엷: IEUNG-YEO-RIEULPIEUP
염: IEUNG-YEO-MIEUM
엽: IEUNG-YEO-PIEUP
엾: IEUNG-YEO-PIEUPSIOS
엿: IEUNG-YEO-SIOS
였: IEUNG-YEO-SSANGSIOS
영: IEUNG-YEO-IEUNG
옅: IEUNG-YEO-THIEUTH
옆: IEUNG-YEO-PHIEUPH
옇: IEUNG-YEO-HIEUH
예: IEUNG-YE
옌: IEUNG-YE-NIEUN
옐: IEUNG-YE-RIEUL
옘: IEUNG-YE-MIEUM
옙: IEUNG-YE-PIEUP
옛: IEUNG-YE-SIOS
옜: IEUNG-YE-SSANGSIOS
오: IEUNG-O
옥: IEUNG-O-KIYEOK
온: IEUNG-O-NIEUN
올: IEUNG-O-RIEUL
옭: IEUNG-O-RIEULKIYEOK
옮: IEUNG-O-RIEULMIEUM
옰: IEUNG-O-RIEULSIOS
옳: IEUNG-O-RIEULHIEUH
옴: IEUNG-O-MIEUM
옵: IEUNG-O-PIEUP
옷: IEUNG-O-SIOS
옹: IEUNG-O-IEUNG
옻: IEUNG-O-CHIEUCH
와: IEUNG-WA
왁: IEUNG-WA-KIYEOK
완: IEUNG-WA-NIEUN
왈: IEUNG-WA-RIEUL
왐: IEUNG-WA-MIEUM
왑: IEUNG-WA-PIEUP
왓: IEUNG-WA-SIOS
왔: IEUNG-WA-SSANGSIOS
왕: IEUNG-WA-IEUNG
왜: IEUNG-WAE
왝: IEUNG-WAE-KIYEOK
왠: IEUNG-WAE-NIEUN
왬: IEUNG-WAE-MIEUM
왯: IEUNG-WAE-SIOS
왱: IEUNG-WAE-IEUNG
외: IEUNG-OE
왹: IEUNG-OE-KIYEOK
왼: IEUNG-OE-NIEUN
욀: IEUNG-OE-RIEUL
욈: IEUNG-OE-MIEUM
욉: IEUNG-OE-PIEUP
욋: IEUNG-OE-SIOS
욍: IEUNG-OE-IEUNG
요: IEUNG-YO
욕: IEUNG-YO-KIYEOK
욘: IEUNG-YO-NIEUN
욜: IEUNG-YO-RIEUL
욤: IEUNG-YO-MIEUM
욥: IEUNG-YO-PIEUP
욧: IEUNG-YO-SIOS
용: IEUNG-YO-IEUNG
우: IEUNG-U
욱: IEUNG-U-KIYEOK
운: IEUNG-U-NIEUN
울: IEUNG-U-RIEUL
욹: IEUNG-U-RIEULKIYEOK
욺: IEUNG-U-RIEULMIEUM
움: IEUNG-U-MIEUM
웁: IEUNG-U-PIEUP
웃: IEUNG-U-SIOS
웅: IEUNG-U-IEUNG
워: IEUNG-WEO
웍: IEUNG-WEO-KIYEOK
원: IEUNG-WEO-NIEUN
월: IEUNG-WEO-RIEUL
웜: IEUNG-WEO-MIEUM
웝: IEUNG-WEO-PIEUP
웠: IEUNG-WEO-SSANGSIOS
웡: IEUNG-WEO-IEUNG
웨: IEUNG-WE
웩: IEUNG-WE-KIYEOK
웬: IEUNG-WE-NIEUN
웰: IEUNG-WE-RIEUL
웸: IEUNG-WE-MIEUM
웹: IEUNG-WE-PIEUP
웽: IEUNG-WE-IEUNG
위: IEUNG-WI
윅: IEUNG-WI-KIYEOK
윈: IEUNG-WI-NIEUN
윌: IEUNG-WI-RIEUL
윔: IEUNG-WI-MIEUM
윕: IEUNG-WI-PIEUP
윗: IEUNG-WI-SIOS
윙: IEUNG-WI-IEUNG
유: IEUNG-YU
육: IEUNG-YU-KIYEOK
윤: IEUNG-YU-NIEUN
율: IEUNG-YU-RIEUL
윰: IEUNG-YU-MIEUM
윱: IEUNG-YU-PIEUP
윳: IEUNG-YU-SIOS
융: IEUNG-YU-IEUNG
윷: IEUNG-YU-CHIEUCH
으: IEUNG-EU
윽: IEUNG-EU-KIYEOK
은: IEUNG-EU-NIEUN
을: IEUNG-EU-RIEUL
읊: IEUNG-EU-RIEULPHIEUPH
음: IEUNG-EU-MIEUM
읍: IEUNG-EU-PIEUP
읏: IEUNG-EU-SIOS
응: IEUNG-EU-IEUNG
읒: IEUNG-EU-CIEUC
읓: IEUNG-EU-CHIEUCH
읔: IEUNG-EU-KHIEUKH
읕: IEUNG-EU-THIEUTH
읖: IEUNG-EU-PHIEUPH
읗: IEUNG-EU-HIEUH
의: IEUNG-YI
읜: IEUNG-YI-NIEUN
읠: IEUNG-YI-RIEUL
읨: IEUNG-YI-MIEUM
읫: IEUNG-YI-SIOS
이: IEUNG-I
익: IEUNG-I-KIYEOK
인: IEUNG-I-NIEUN
일: IEUNG-I-RIEUL
읽: IEUNG-I-RIEULKIYEOK
읾: IEUNG-I-RIEULMIEUM
잃: IEUNG-I-RIEULHIEUH
임: IEUNG-I-MIEUM
입: IEUNG-I-PIEUP
잇: IEUNG-I-SIOS
있: IEUNG-I-SSANGSIOS
잉: IEUNG-I-IEUNG
잊: IEUNG-I-CIEUC
잎: IEUNG-I-PHIEUPH
자: CIEUC-A
작: CIEUC-A-KIYEOK
잔: CIEUC-A-NIEUN
잖: CIEUC-A-NIEUNHIEUH
잗: CIEUC-A-TIKEUT
잘: CIEUC-A-RIEUL
잚: CIEUC-A-RIEULMIEUM
잠: CIEUC-A-MIEUM
잡: CIEUC-A-PIEUP
잣: CIEUC-A-SIOS
잤: CIEUC-A-SSANGSIOS
장: CIEUC-A-IEUNG
잦: CIEUC-A-CIEUC
재: CIEUC-AE
잭: CIEUC-AE-KIYEOK
잰: CIEUC-AE-NIEUN
잴: CIEUC-AE-RIEUL
잼: CIEUC-AE-MIEUM
잽: CIEUC-AE-PIEUP
잿: CIEUC-AE-SIOS
쟀: CIEUC-AE-SSANGSIOS
쟁: CIEUC-AE-IEUNG
쟈: CIEUC-YA
쟉: CIEUC-YA-KIYEOK
쟌: CIEUC-YA-NIEUN
쟎: CIEUC-YA-NIEUNHIEUH
쟐: CIEUC-YA-RIEUL
쟘: CIEUC-YA-MIEUM
쟝: CIEUC-YA-IEUNG
쟤: CIEUC-YAE
쟨: CIEUC-YAE-NIEUN
쟬: CIEUC-YAE-RIEUL
저: CIEUC-EO
적: CIEUC-EO-KIYEOK
전: CIEUC-EO-NIEUN
절: CIEUC-EO-RIEUL
젊: CIEUC-EO-RIEULMIEUM
점: CIEUC-EO-MIEUM
접: CIEUC-EO-PIEUP
젓: CIEUC-EO-SIOS
정: CIEUC-EO-IEUNG
젖: CIEUC-EO-CIEUC
제: CIEUC-E
젝: CIEUC-E-KIYEOK
젠: CIEUC-E-NIEUN
젤: CIEUC-E-RIEUL
젬: CIEUC-E-MIEUM
젭: CIEUC-E-PIEUP
젯: CIEUC-E-SIOS
젱: CIEUC-E-IEUNG
져: CIEUC-YEO
젼: CIEUC-YEO-NIEUN
졀: CIEUC-YEO-RIEUL
졈: CIEUC-YEO-MIEUM
졉: CIEUC-YEO-PIEUP
졌: CIEUC-YEO-SSANGSIOS
졍: CIEUC-YEO-IEUNG
졔: CIEUC-YE
조: CIEUC-O
족: CIEUC-O-KIYEOK
존: CIEUC-O-NIEUN
졸: CIEUC-O-RIEUL
졺: CIEUC-O-RIEULMIEUM
좀: CIEUC-O-MIEUM
좁: CIEUC-O-PIEUP
좃: CIEUC-O-SIOS
종: CIEUC-O-IEUNG
좆: CIEUC-O-CIEUC
좇: CIEUC-O-CHIEUCH
좋: CIEUC-O-HIEUH
좌: CIEUC-WA
좍: CIEUC-WA-KIYEOK
좔: CIEUC-WA-RIEUL
좝: CIEUC-WA-PIEUP
좟: CIEUC-WA-SIOS
좡: CIEUC-WA-IEUNG
좨: CIEUC-WAE
좼: CIEUC-WAE-SSANGSIOS
좽: CIEUC-WAE-IEUNG
죄: CIEUC-OE
죈: CIEUC-OE-NIEUN
죌: CIEUC-OE-RIEUL
죔: CIEUC-OE-MIEUM
죕: CIEUC-OE-PIEUP
죗: CIEUC-OE-SIOS
죙: CIEUC-OE-IEUNG
죠: CIEUC-YO
죡: CIEUC-YO-KIYEOK
죤: CIEUC-YO-NIEUN
죵: CIEUC-YO-IEUNG
주: CIEUC-U
죽: CIEUC-U-KIYEOK
준: CIEUC-U-NIEUN
줄: CIEUC-U-RIEUL
줅: CIEUC-U-RIEULKIYEOK
줆: CIEUC-U-RIEULMIEUM
줌: CIEUC-U-MIEUM
줍: CIEUC-U-PIEUP
줏: CIEUC-U-SIOS
중: CIEUC-U-IEUNG
줘: CIEUC-WEO
줬: CIEUC-WEO-SSANGSIOS
줴: CIEUC-WE
쥐: CIEUC-WI
쥑: CIEUC-WI-KIYEOK
쥔: CIEUC-WI-NIEUN
쥘: CIEUC-WI-RIEUL
쥠: CIEUC-WI-MIEUM
쥡: CIEUC-WI-PIEUP
쥣: CIEUC-WI-SIOS
쥬: CIEUC-YU
쥰: CIEUC-YU-NIEUN
쥴: CIEUC-YU-RIEUL
쥼: CIEUC-YU-MIEUM
즈: CIEUC-EU
즉: CIEUC-EU-KIYEOK
즌: CIEUC-EU-NIEUN
즐: CIEUC-EU-RIEUL
즘: CIEUC-EU-MIEUM
즙: CIEUC-EU-PIEUP
즛: CIEUC-EU-SIOS
증: CIEUC-EU-IEUNG
지: CIEUC-I
직: CIEUC-I-KIYEOK
진: CIEUC-I-NIEUN
짇: CIEUC-I-TIKEUT
질: CIEUC-I-RIEUL
짊: CIEUC-I-RIEULMIEUM
짐: CIEUC-I-MIEUM
집: CIEUC-I-PIEUP
짓: CIEUC-I-SIOS
징: CIEUC-I-IEUNG
짖: CIEUC-I-CIEUC
짙: CIEUC-I-THIEUTH
짚: CIEUC-I-PHIEUPH
짜: SSANGCIEUC-A
짝: SSANGCIEUC-A-KIYEOK
짠: SSANGCIEUC-A-NIEUN
짢: SSANGCIEUC-A-NIEUNHIEUH
짤: SSANGCIEUC-A-RIEUL
짧: SSANGCIEUC-A-RIEULPIEUP
짬: SSANGCIEUC-A-MIEUM
짭: SSANGCIEUC-A-PIEUP
짯: SSANGCIEUC-A-SIOS
짰: SSANGCIEUC-A-SSANGSIOS
짱: SSANGCIEUC-A-IEUNG
째: SSANGCIEUC-AE
짹: SSANGCIEUC-AE-KIYEOK
짼: SSANGCIEUC-AE-NIEUN
쨀: SSANGCIEUC-AE-RIEUL
쨈: SSANGCIEUC-AE-MIEUM
쨉: SSANGCIEUC-AE-PIEUP
쨋: SSANGCIEUC-AE-SIOS
쨌: SSANGCIEUC-AE-SSANGSIOS
쨍: SSANGCIEUC-AE-IEUNG
쨔: SSANGCIEUC-YA
쨘: SSANGCIEUC-YA-NIEUN
쨩: SSANGCIEUC-YA-IEUNG
쩌: SSANGCIEUC-EO
쩍: SSANGCIEUC-EO-KIYEOK
쩐: SSANGCIEUC-EO-NIEUN
쩔: SSANGCIEUC-EO-RIEUL
쩜: SSANGCIEUC-EO-MIEUM
쩝: SSANGCIEUC-EO-PIEUP
쩟: SSANGCIEUC-EO-SIOS
쩠: SSANGCIEUC-EO-SSANGSIOS
쩡: SSANGCIEUC-EO-IEUNG
쩨: SSANGCIEUC-E
쩽: SSANGCIEUC-E-IEUNG
쪄: SSANGCIEUC-YEO
쪘: SSANGCIEUC-YEO-SSANGSIOS
쪼: SSANGCIEUC-O
쪽: SSANGCIEUC-O-KIYEOK
쫀: SSANGCIEUC-O-NIEUN
쫄: SSANGCIEUC-O-RIEUL
쫌: SSANGCIEUC-O-MIEUM
쫍: SSANGCIEUC-O-PIEUP
쫏: SSANGCIEUC-O-SIOS
쫑: SSANGCIEUC-O-IEUNG
쫓: SSANGCIEUC-O-CHIEUCH
쫘: SSANGCIEUC-WA
쫙: SSANGCIEUC-WA-KIYEOK
쫠: SSANGCIEUC-WA-RIEUL
쫬: SSANGCIEUC-WA-SSANGSIOS
쫴: SSANGCIEUC-WAE
쬈: SSANGCIEUC-WAE-SSANGSIOS
쬐: SSANGCIEUC-OE
쬔: SSANGCIEUC-OE-NIEUN
쬘: SSANGCIEUC-OE-RIEUL
쬠: SSANGCIEUC-OE-MIEUM
쬡: SSANGCIEUC-OE-PIEUP
쭁: SSANGCIEUC-YO-IEUNG
쭈: SSANGCIEUC-U
쭉: SSANGCIEUC-U-KIYEOK
쭌: SSANGCIEUC-U-NIEUN
쭐: SSANGCIEUC-U-RIEUL
쭘: SSANGCIEUC-U-MIEUM
쭙: SSANGCIEUC-U-PIEUP
쭝: SSANGCIEUC-U-IEUNG
쭤: SSANGCIEUC-WEO
쭸: SSANGCIEUC-WEO-SSANGSIOS
쭹: SSANGCIEUC-WEO-IEUNG
쮜: SSANGCIEUC-WI
쮸: SSANGCIEUC-YU
쯔: SSANGCIEUC-EU
쯤: SSANGCIEUC-EU-MIEUM
쯧: SSANGCIEUC-EU-SIOS
쯩: SSANGCIEUC-EU-IEUNG
찌: SSANGCIEUC-I
찍: SSANGCIEUC-I-KIYEOK
찐: SSANGCIEUC-I-NIEUN
찔: SSANGCIEUC-I-RIEUL
찜: SSANGCIEUC-I-MIEUM
찝: SSANGCIEUC-I-PIEUP
찡: SSANGCIEUC-I-IEUNG
찢: SSANGCIEUC-I-CIEUC
찧: SSANGCIEUC-I-HIEUH
차: CHIEUCH-A
착: CHIEUCH-A-KIYEOK
찬: CHIEUCH-A-NIEUN
찮: CHIEUCH-A-NIEUNHIEUH
찰: CHIEUCH-A-RIEUL
참: CHIEUCH-A-MIEUM
찹: CHIEUCH-A-PIEUP
찻: CHIEUCH-A-SIOS
찼: CHIEUCH-A-SSANGSIOS
창: CHIEUCH-A-IEUNG
찾: CHIEUCH-A-CIEUC
채: CHIEUCH-AE
책: CHIEUCH-AE-KIYEOK
챈: CHIEUCH-AE-NIEUN
챌: CHIEUCH-AE-RIEUL
챔: CHIEUCH-AE-MIEUM
챕: CHIEUCH-AE-PIEUP
챗: CHIEUCH-AE-SIOS
챘: CHIEUCH-AE-SSANGSIOS
챙: CHIEUCH-AE-IEUNG
챠: CHIEUCH-YA
챤: CHIEUCH-YA-NIEUN
챦: CHIEUCH-YA-NIEUNHIEUH
챨: CHIEUCH-YA-RIEUL
챰: CHIEUCH-YA-MIEUM
챵: CHIEUCH-YA-IEUNG
처: CHIEUCH-EO
척: CHIEUCH-EO-KIYEOK
천: CHIEUCH-EO-NIEUN
철: CHIEUCH-EO-RIEUL
첨: CHIEUCH-EO-MIEUM
첩: CHIEUCH-EO-PIEUP
첫: CHIEUCH-EO-SIOS
첬: CHIEUCH-EO-SSANGSIOS
청: CHIEUCH-EO-IEUNG
체: CHIEUCH-E
첵: CHIEUCH-E-KIYEOK
첸: CHIEUCH-E-NIEUN
첼: CHIEUCH-E-RIEUL
쳄: CHIEUCH-E-MIEUM
쳅: CHIEUCH-E-PIEUP
쳇: CHIEUCH-E-SIOS
쳉: CHIEUCH-E-IEUNG
쳐: CHIEUCH-YEO
쳔: CHIEUCH-YEO-NIEUN
쳤: CHIEUCH-YEO-SSANGSIOS
쳬: CHIEUCH-YE
쳰: CHIEUCH-YE-NIEUN
촁: CHIEUCH-YE-IEUNG
초: CHIEUCH-O
촉: CHIEUCH-O-KIYEOK
촌: CHIEUCH-O-NIEUN
촐: CHIEUCH-O-RIEUL
촘: CHIEUCH-O-MIEUM
촙: CHIEUCH-O-PIEUP
촛: CHIEUCH-O-SIOS
총: CHIEUCH-O-IEUNG
촤: CHIEUCH-WA
촨: CHIEUCH-WA-NIEUN
촬: CHIEUCH-WA-RIEUL
촹: CHIEUCH-WA-IEUNG
최: CHIEUCH-OE
쵠: CHIEUCH-OE-NIEUN
쵤: CHIEUCH-OE-RIEUL
쵬: CHIEUCH-OE-MIEUM
쵭: CHIEUCH-OE-PIEUP
쵯: CHIEUCH-OE-SIOS
쵱: CHIEUCH-OE-IEUNG
쵸: CHIEUCH-YO
춈: CHIEUCH-YO-MIEUM
추: CHIEUCH-U
축: CHIEUCH-U-KIYEOK
춘: CHIEUCH-U-NIEUN
출: CHIEUCH-U-RIEUL
춤: CHIEUCH-U-MIEUM
춥: CHIEUCH-U-PIEUP
춧: CHIEUCH-U-SIOS
충: CHIEUCH-U-IEUNG
춰: CHIEUCH-WEO
췄: CHIEUCH-WEO-SSANGSIOS
췌: CHIEUCH-WE
췐: CHIEUCH-WE-NIEUN
취: CHIEUCH-WI
췬: CHIEUCH-WI-NIEUN
췰: CHIEUCH-WI-RIEUL
췸: CHIEUCH-WI-MIEUM
췹: CHIEUCH-WI-PIEUP
췻: CHIEUCH-WI-SIOS
췽: CHIEUCH-WI-IEUNG
츄: CHIEUCH-YU
츈: CHIEUCH-YU-NIEUN
츌: CHIEUCH-YU-RIEUL
츔: CHIEUCH-YU-MIEUM
츙: CHIEUCH-YU-IEUNG
츠: CHIEUCH-EU
측: CHIEUCH-EU-KIYEOK
츤: CHIEUCH-EU-NIEUN
츨: CHIEUCH-EU-RIEUL
츰: CHIEUCH-EU-MIEUM
츱: CHIEUCH-EU-PIEUP
츳: CHIEUCH-EU-SIOS
층: CHIEUCH-EU-IEUNG
치: CHIEUCH-I
칙: CHIEUCH-I-KIYEOK
친: CHIEUCH-I-NIEUN
칟: CHIEUCH-I-TIKEUT
칠: CHIEUCH-I-RIEUL
칡: CHIEUCH-I-RIEULKIYEOK
침: CHIEUCH-I-MIEUM
칩: CHIEUCH-I-PIEUP
칫: CHIEUCH-I-SIOS
칭: CHIEUCH-I-IEUNG
카: KHIEUKH-A
칵: KHIEUKH-A-KIYEOK
칸: KHIEUKH-A-NIEUN
칼: KHIEUKH-A-RIEUL
캄: KHIEUKH-A-MIEUM
캅: KHIEUKH-A-PIEUP
캇: KHIEUKH-A-SIOS
캉: KHIEUKH-A-IEUNG
캐: KHIEUKH-AE
캑: KHIEUKH-AE-KIYEOK
캔: KHIEUKH-AE-NIEUN
캘: KHIEUKH-AE-RIEUL
캠: KHIEUKH-AE-MIEUM
캡: KHIEUKH-AE-PIEUP
캣: KHIEUKH-AE-SIOS
캤: KHIEUKH-AE-SSANGSIOS
캥: KHIEUKH-AE-IEUNG
캬: KHIEUKH-YA
캭: KHIEUKH-YA-KIYEOK
컁: KHIEUKH-YA-IEUNG
커: KHIEUKH-EO
컥: KHIEUKH-EO-KIYEOK
컨: KHIEUKH-EO-NIEUN
컫: KHIEUKH-EO-TIKEUT
컬: KHIEUKH-EO-RIEUL
컴: KHIEUKH-EO-MIEUM
컵: KHIEUKH-EO-PIEUP
컷: KHIEUKH-EO-SIOS
컸: KHIEUKH-EO-SSANGSIOS
컹: KHIEUKH-EO-IEUNG
케: KHIEUKH-E
켁: KHIEUKH-E-KIYEOK
켄: KHIEUKH-E-NIEUN
켈: KHIEUKH-E-RIEUL
켐: KHIEUKH-E-MIEUM
켑: KHIEUKH-E-PIEUP
켓: KHIEUKH-E-SIOS
켕: KHIEUKH-E-IEUNG
켜: KHIEUKH-YEO
켠: KHIEUKH-YEO-NIEUN
켤: KHIEUKH-YEO-RIEUL
켬: KHIEUKH-YEO-MIEUM
켭: KHIEUKH-YEO-PIEUP
켯: KHIEUKH-YEO-SIOS
켰: KHIEUKH-YEO-SSANGSIOS
켱: KHIEUKH-YEO-IEUNG
켸: KHIEUKH-YE
코: KHIEUKH-O
콕: KHIEUKH-O-KIYEOK
콘: KHIEUKH-O-NIEUN
콜: KHIEUKH-O-RIEUL
콤: KHIEUKH-O-MIEUM
콥: KHIEUKH-O-PIEUP
콧: KHIEUKH-O-SIOS
콩: KHIEUKH-O-IEUNG
콰: KHIEUKH-WA
콱: KHIEUKH-WA-KIYEOK
콴: KHIEUKH-WA-NIEUN
콸: KHIEUKH-WA-RIEUL
쾀: KHIEUKH-WA-MIEUM
쾅: KHIEUKH-WA-IEUNG
쾌: KHIEUKH-WAE
쾡: KHIEUKH-WAE-IEUNG
쾨: KHIEUKH-OE
쾰: KHIEUKH-OE-RIEUL
쿄: KHIEUKH-YO
쿠: KHIEUKH-U
쿡: KHIEUKH-U-KIYEOK
쿤: KHIEUKH-U-NIEUN
쿨: KHIEUKH-U-RIEUL
쿰: KHIEUKH-U-MIEUM
쿱: KHIEUKH-U-PIEUP
쿳: KHIEUKH-U-SIOS
쿵: KHIEUKH-U-IEUNG
쿼: KHIEUKH-WEO
퀀: KHIEUKH-WEO-NIEUN
퀄: KHIEUKH-WEO-RIEUL
퀑: KHIEUKH-WEO-IEUNG
퀘: KHIEUKH-WE
퀭: KHIEUKH-WE-IEUNG
퀴: KHIEUKH-WI
퀵: KHIEUKH-WI-KIYEOK
퀸: KHIEUKH-WI-NIEUN
퀼: KHIEUKH-WI-RIEUL
큄: KHIEUKH-WI-MIEUM
큅: KHIEUKH-WI-PIEUP
큇: KHIEUKH-WI-SIOS
큉: KHIEUKH-WI-IEUNG
큐: KHIEUKH-YU
큔: KHIEUKH-YU-NIEUN
큘: KHIEUKH-YU-RIEUL
큠: KHIEUKH-YU-MIEUM
크: KHIEUKH-EU
큭: KHIEUKH-EU-KIYEOK
큰: KHIEUKH-EU-NIEUN
클: KHIEUKH-EU-RIEUL
큼: KHIEUKH-EU-MIEUM
큽: KHIEUKH-EU-PIEUP
킁: KHIEUKH-EU-IEUNG
키: KHIEUKH-I
킥: KHIEUKH-I-KIYEOK
킨: KHIEUKH-I-NIEUN
킬: KHIEUKH-I-RIEUL
킴: KHIEUKH-I-MIEUM
킵: KHIEUKH-I-PIEUP
킷: KHIEUKH-I-SIOS
킹: KHIEUKH-I-IEUNG
타: THIEUTH-A
탁: THIEUTH-A-KIYEOK
탄: THIEUTH-A-NIEUN
탈: THIEUTH-A-RIEUL
탉: THIEUTH-A-RIEULKIYEOK
탐: THIEUTH-A-MIEUM
탑: THIEUTH-A-PIEUP
탓: THIEUTH-A-SIOS
탔: THIEUTH-A-SSANGSIOS
탕: THIEUTH-A-IEUNG
태: THIEUTH-AE
택: THIEUTH-AE-KIYEOK
탠: THIEUTH-AE-NIEUN
탤: THIEUTH-AE-RIEUL
탬: THIEUTH-AE-MIEUM
탭: THIEUTH-AE-PIEUP
탯: THIEUTH-AE-SIOS
탰: THIEUTH-AE-SSANGSIOS
탱: THIEUTH-AE-IEUNG
탸: THIEUTH-YA
턍: THIEUTH-YA-IEUNG
터: THIEUTH-EO
턱: THIEUTH-EO-KIYEOK
턴: THIEUTH-EO-NIEUN
털: THIEUTH-EO-RIEUL
턺: THIEUTH-EO-RIEULMIEUM
텀: THIEUTH-EO-MIEUM
텁: THIEUTH-EO-PIEUP
텃: THIEUTH-EO-SIOS
텄: THIEUTH-EO-SSANGSIOS
텅: THIEUTH-EO-IEUNG
테: THIEUTH-E
텍: THIEUTH-E-KIYEOK
텐: THIEUTH-E-NIEUN
텔: THIEUTH-E-RIEUL
템: THIEUTH-E-MIEUM
텝: THIEUTH-E-PIEUP
텟: THIEUTH-E-SIOS
텡: THIEUTH-E-IEUNG
텨: THIEUTH-YEO
텬: THIEUTH-YEO-NIEUN
텼: THIEUTH-YEO-SSANGSIOS
톄: THIEUTH-YE
톈: THIEUTH-YE-NIEUN
토: THIEUTH-O
톡: THIEUTH-O-KIYEOK
톤: THIEUTH-O-NIEUN
톨: THIEUTH-O-RIEUL
톰: THIEUTH-O-MIEUM
톱: THIEUTH-O-PIEUP
톳: THIEUTH-O-SIOS
통: THIEUTH-O-IEUNG
톺: THIEUTH-O-PHIEUPH
톼: THIEUTH-WA
퇀: THIEUTH-WA-NIEUN
퇘: THIEUTH-WAE
퇴: THIEUTH-OE
퇸: THIEUTH-OE-NIEUN
툇: THIEUTH-OE-SIOS
툉: THIEUTH-OE-IEUNG
툐: THIEUTH-YO
투: THIEUTH-U
툭: THIEUTH-U-KIYEOK
툰: THIEUTH-U-NIEUN
툴: THIEUTH-U-RIEUL
툼: THIEUTH-U-MIEUM
툽: THIEUTH-U-PIEUP
툿: THIEUTH-U-SIOS
퉁: THIEUTH-U-IEUNG
퉈: THIEUTH-WEO
퉜: THIEUTH-WEO-SSANGSIOS
퉤: THIEUTH-WE
튀: THIEUTH-WI
튁: THIEUTH-WI-KIYEOK
튄: THIEUTH-WI-NIEUN
튈: THIEUTH-WI-RIEUL
튐: THIEUTH-WI-MIEUM
튑: THIEUTH-WI-PIEUP
튕: THIEUTH-WI-IEUNG
튜: THIEUTH-YU
튠: THIEUTH-YU-NIEUN
튤: THIEUTH-YU-RIEUL
튬: THIEUTH-YU-MIEUM
튱: THIEUTH-YU-IEUNG
트: THIEUTH-EU
특: THIEUTH-EU-KIYEOK
튼: THIEUTH-EU-NIEUN
튿: THIEUTH-EU-TIKEUT
틀: THIEUTH-EU-RIEUL
틂: THIEUTH-EU-RIEULMIEUM
틈: THIEUTH-EU-MIEUM
틉: THIEUTH-EU-PIEUP
틋: THIEUTH-EU-SIOS
틔: THIEUTH-YI
틘: THIEUTH-YI-NIEUN
틜: THIEUTH-YI-RIEUL
틤: THIEUTH-YI-MIEUM
틥: THIEUTH-YI-PIEUP
티: THIEUTH-I
틱: THIEUTH-I-KIYEOK
틴: THIEUTH-I-NIEUN
틸: THIEUTH-I-RIEUL
팀: THIEUTH-I-MIEUM
팁: THIEUTH-I-PIEUP
팃: THIEUTH-I-SIOS
팅: THIEUTH-I-IEUNG
파: PHIEUPH-A
팍: PHIEUPH-A-KIYEOK
팎: PHIEUPH-A-SSANGKIYEOK
판: PHIEUPH-A-NIEUN
팔: PHIEUPH-A-RIEUL
팖: PHIEUPH-A-RIEULMIEUM
팜: PHIEUPH-A-MIEUM
팝: PHIEUPH-A-PIEUP
팟: PHIEUPH-A-SIOS
팠: PHIEUPH-A-SSANGSIOS
팡: PHIEUPH-A-IEUNG
팥: PHIEUPH-A-THIEUTH
패: PHIEUPH-AE
팩: PHIEUPH-AE-KIYEOK
팬: PHIEUPH-AE-NIEUN
팰: PHIEUPH-AE-RIEUL
팸: PHIEUPH-AE-MIEUM
팹: PHIEUPH-AE-PIEUP
팻: PHIEUPH-AE-SIOS
팼: PHIEUPH-AE-SSANGSIOS
팽: PHIEUPH-AE-IEUNG
퍄: PHIEUPH-YA
퍅: PHIEUPH-YA-KIYEOK
퍼: PHIEUPH-EO
퍽: PHIEUPH-EO-KIYEOK
펀: PHIEUPH-EO-NIEUN
펄: PHIEUPH-EO-RIEUL
펌: PHIEUPH-EO-MIEUM
펍: PHIEUPH-EO-PIEUP
펏: PHIEUPH-EO-SIOS
펐: PHIEUPH-EO-SSANGSIOS
펑: PHIEUPH-EO-IEUNG
페: PHIEUPH-E
펙: PHIEUPH-E-KIYEOK
펜: PHIEUPH-E-NIEUN
펠: PHIEUPH-E-RIEUL
펨: PHIEUPH-E-MIEUM
펩: PHIEUPH-E-PIEUP
펫: PHIEUPH-E-SIOS
펭: PHIEUPH-E-IEUNG
펴: PHIEUPH-YEO
편: PHIEUPH-YEO-NIEUN
펼: PHIEUPH-YEO-RIEUL
폄: PHIEUPH-YEO-MIEUM
폅: PHIEUPH-YEO-PIEUP
폈: PHIEUPH-YEO-SSANGSIOS
평: PHIEUPH-YEO-IEUNG
폐: PHIEUPH-YE
폘: PHIEUPH-YE-RIEUL
폡: PHIEUPH-YE-PIEUP
폣: PHIEUPH-YE-SIOS
포: PHIEUPH-O
폭: PHIEUPH-O-KIYEOK
폰: PHIEUPH-O-NIEUN
폴: PHIEUPH-O-RIEUL
폼: PHIEUPH-O-MIEUM
폽: PHIEUPH-O-PIEUP
폿: PHIEUPH-O-SIOS
퐁: PHIEUPH-O-IEUNG
퐈: PHIEUPH-WA
퐝: PHIEUPH-WA-IEUNG
푀: PHIEUPH-OE
푄: PHIEUPH-OE-NIEUN
표: PHIEUPH-YO
푠: PHIEUPH-YO-NIEUN
푤: PHIEUPH-YO-RIEUL
푭: PHIEUPH-YO-PIEUP
푯: PHIEUPH-YO-SIOS
푸: PHIEUPH-U
푹: PHIEUPH-U-KIYEOK
푼: PHIEUPH-U-NIEUN
푿: PHIEUPH-U-TIKEUT
풀: PHIEUPH-U-RIEUL
풂: PHIEUPH-U-RIEULMIEUM
품: PHIEUPH-U-MIEUM
풉: PHIEUPH-U-PIEUP
풋: PHIEUPH-U-SIOS
풍: PHIEUPH-U-IEUNG
풔: PHIEUPH-WEO
풩: PHIEUPH-WEO-IEUNG
퓌: PHIEUPH-WI
퓐: PHIEUPH-WI-NIEUN
퓔: PHIEUPH-WI-RIEUL
퓜: PHIEUPH-WI-MIEUM
퓟: PHIEUPH-WI-SIOS
퓨: PHIEUPH-YU
퓬: PHIEUPH-YU-NIEUN
퓰: PHIEUPH-YU-RIEUL
퓸: PHIEUPH-YU-MIEUM
퓻: PHIEUPH-YU-SIOS
퓽: PHIEUPH-YU-IEUNG
프: PHIEUPH-EU
픈: PHIEUPH-EU-NIEUN
플: PHIEUPH-EU-RIEUL
픔: PHIEUPH-EU-MIEUM
픕: PHIEUPH-EU-PIEUP
픗: PHIEUPH-EU-SIOS
피: PHIEUPH-I
픽: PHIEUPH-I-KIYEOK
핀: PHIEUPH-I-NIEUN
필: PHIEUPH-I-RIEUL
핌: PHIEUPH-I-MIEUM
핍: PHIEUPH-I-PIEUP
핏: PHIEUPH-I-SIOS
핑: PHIEUPH-I-IEUNG
하: HIEUH-A
학: HIEUH-A-KIYEOK
한: HIEUH-A-NIEUN
할: HIEUH-A-RIEUL
핥: HIEUH-A-RIEULTHIEUTH
함: HIEUH-A-MIEUM
합: HIEUH-A-PIEUP
핫: HIEUH-A-SIOS
항: HIEUH-A-IEUNG
해: HIEUH-AE
핵: HIEUH-AE-KIYEOK
핸: HIEUH-AE-NIEUN
핼: HIEUH-AE-RIEUL
햄: HIEUH-AE-MIEUM
햅: HIEUH-AE-PIEUP
햇: HIEUH-AE-SIOS
했: HIEUH-AE-SSANGSIOS
행: HIEUH-AE-IEUNG
햐: HIEUH-YA
향: HIEUH-YA-IEUNG
허: HIEUH-EO
헉: HIEUH-EO-KIYEOK
헌: HIEUH-EO-NIEUN
헐: HIEUH-EO-RIEUL
헒: HIEUH-EO-RIEULMIEUM
험: HIEUH-EO-MIEUM
헙: HIEUH-EO-PIEUP
헛: HIEUH-EO-SIOS
헝: HIEUH-EO-IEUNG
헤: HIEUH-E
헥: HIEUH-E-KIYEOK
헨: HIEUH-E-NIEUN
헬: HIEUH-E-RIEUL
헴: HIEUH-E-MIEUM
헵: HIEUH-E-PIEUP
헷: HIEUH-E-SIOS
헹: HIEUH-E-IEUNG
혀: HIEUH-YEO
혁: HIEUH-YEO-KIYEOK
현: HIEUH-YEO-NIEUN
혈: HIEUH-YEO-RIEUL
혐: HIEUH-YEO-MIEUM
협: HIEUH-YEO-PIEUP
혓: HIEUH-YEO-SIOS
혔: HIEUH-YEO-SSANGSIOS
형: HIEUH-YEO-IEUNG
혜: HIEUH-YE
혠: HIEUH-YE-NIEUN
혤: HIEUH-YE-RIEUL
혭: HIEUH-YE-PIEUP
호: HIEUH-O
혹: HIEUH-O-KIYEOK
혼: HIEUH-O-NIEUN
홀: HIEUH-O-RIEUL
홅: HIEUH-O-RIEULTHIEUTH
홈: HIEUH-O-MIEUM
홉: HIEUH-O-PIEUP
홋: HIEUH-O-SIOS
홍: HIEUH-O-IEUNG
홑: HIEUH-O-THIEUTH
화: HIEUH-WA
확: HIEUH-WA-KIYEOK
환: HIEUH-WA-NIEUN
활: HIEUH-WA-RIEUL
홧: HIEUH-WA-SIOS
황: HIEUH-WA-IEUNG
홰: HIEUH-WAE
홱: HIEUH-WAE-KIYEOK
홴: HIEUH-WAE-NIEUN
횃: HIEUH-WAE-SIOS
횅: HIEUH-WAE-IEUNG
회: HIEUH-OE
획: HIEUH-OE-KIYEOK
횐: HIEUH-OE-NIEUN
횔: HIEUH-OE-RIEUL
횝: HIEUH-OE-PIEUP
횟: HIEUH-OE-SIOS
횡: HIEUH-OE-IEUNG
효: HIEUH-YO
횬: HIEUH-YO-NIEUN
횰: HIEUH-YO-RIEUL
횹: HIEUH-YO-PIEUP
횻: HIEUH-YO-SIOS
후: HIEUH-U
훅: HIEUH-U-KIYEOK
훈: HIEUH-U-NIEUN
훌: HIEUH-U-RIEUL
훑: HIEUH-U-RIEULTHIEUTH
훔: HIEUH-U-MIEUM
훗: HIEUH-U-SIOS
훙: HIEUH-U-IEUNG
훠: HIEUH-WEO
훤: HIEUH-WEO-NIEUN
훨: HIEUH-WEO-RIEUL
훰: HIEUH-WEO-MIEUM
훵: HIEUH-WEO-IEUNG
훼: HIEUH-WE
훽: HIEUH-WE-KIYEOK
휀: HIEUH-WE-NIEUN
휄: HIEUH-WE-RIEUL
휑: HIEUH-WE-IEUNG
휘: HIEUH-WI
휙: HIEUH-WI-KIYEOK
휜: HIEUH-WI-NIEUN
휠: HIEUH-WI-RIEUL
휨: HIEUH-WI-MIEUM
휩: HIEUH-WI-PIEUP
휫: HIEUH-WI-SIOS
휭: HIEUH-WI-IEUNG
휴: HIEUH-YU
휵: HIEUH-YU-KIYEOK
휸: HIEUH-YU-NIEUN
휼: HIEUH-YU-RIEUL
흄: HIEUH-YU-MIEUM
흇: HIEUH-YU-SIOS
흉: HIEUH-YU-IEUNG
흐: HIEUH-EU
흑: HIEUH-EU-KIYEOK
흔: HIEUH-EU-NIEUN
흖: HIEUH-EU-NIEUNHIEUH
흗: HIEUH-EU-TIKEUT
흘: HIEUH-EU-RIEUL
흙: HIEUH-EU-RIEULKIYEOK
흠: HIEUH-EU-MIEUM
흡: HIEUH-EU-PIEUP
흣: HIEUH-EU-SIOS
흥: HIEUH-EU-IEUNG
흩: HIEUH-EU-THIEUTH
희: HIEUH-YI
흰: HIEUH-YI-NIEUN
흴: HIEUH-YI-RIEUL
흼: HIEUH-YI-MIEUM
흽: HIEUH-YI-PIEUP
힁: HIEUH-YI-IEUNG
히: HIEUH-I
힉: HIEUH-I-KIYEOK
힌: HIEUH-I-NIEUN
힐: HIEUH-I-RIEUL
힘: HIEUH-I-MIEUM
힙: HIEUH-I-PIEUP
힛: HIEUH-I-SIOS
힝: HIEUH-I-IEUNG
